,As,Cs,Gs,Ns,Ts,coverage,majorbases,majorsequence,position
0,148,61,30,0,30,269,148,a,0
1,65,45,265,0,66,441,265,g,1
2,82,40,201,0,203,526,203,t,2
3,81,108,150,0,244,583,244,t,3
4,41,36,411,0,145,633,411,g,4
5,45,38,108,0,495,686,495,t,5
6,43,77,138,0,476,734,476,t,6
7,252,110,236,0,159,757,252,a,7
8,15,18,602,0,191,826,602,g,8
9,75,119,102,0,633,929,633,t,9
10,97,402,214,0,269,982,402,c,10
11,33,77,100,0,806,1016,806,t,11
12,577,26,188,0,3957,4748,3957,t,12
13,167,6223,82,0,453,6925,6223,c,13
14,17,101,6844,0,453,7415,6844,g,14
15,55,59,27,0,7891,8032,7891,t,15
16,62,30,8118,0,675,8885,8118,g,16
17,71,37,8838,0,298,9244,8838,g,17
18,8783,146,126,0,1416,10471,8783,a,18
19,67,10780,148,0,1802,12797,10780,c,19
20,119,13250,116,0,4128,17613,13250,c,20
21,34,81,19536,0,492,20143,19536,g,21
22,19888,131,101,0,8466,28586,19888,a,22
23,116,32680,104,0,705,33605,32680,c,23
24,33419,102,209,0,1118,34848,33419,a,24
25,34812,237,129,0,423,35601,34812,a,25
26,35267,184,94,0,4497,40042,35267,a,26
27,57,64,42054,0,630,42805,42054,g,27
28,42465,137,105,0,2980,45687,42465,a,28
29,146,46890,82,0,814,47932,46890,c,29
30,47781,188,232,0,2002,50203,47781,a,30
31,58,39,51055,0,857,52009,51055,g,31
32,51805,211,187,0,280,52483,51805,a,32
33,79,43,79,0,52399,52600,52399,t,33
34,36,35,104,0,55975,56150,55975,t,34
35,205,57796,118,0,508,58627,57796,c,35
36,44,95,81,0,58490,58710,58490,t,36
37,57,54,74,0,58629,58814,58629,t,37
38,56,54,154,0,59004,59268,59004,t,38
39,86,86,59300,0,283,59755,59300,g,39
40,59221,354,101,0,667,60343,59221,a,40
41,78,140,60340,0,284,60842,60340,g,41
42,114,102,60379,0,412,61007,60379,g,42
43,63,113,60743,0,327,61246,60743,g,43
44,60737,266,125,0,1121,62249,60737,a,44
45,55,139,62518,0,1357,64069,62518,g,45
46,210,64086,99,0,605,65000,64086,c,46
47,50,53,115,0,64865,65083,64865,t,47
48,64446,230,201,0,343,65220,64446,a,48
49,64843,195,88,0,3666,68792,64843,a,49
50,66,78,71225,0,1196,72565,71225,g,50
51,188,72774,115,0,391,73468,72774,c,51
52,95,120,89,0,73443,73747,73443,t,52
53,193,73247,138,0,431,74009,73247,c,53
54,73674,155,95,0,183,74107,73674,a,54
55,73694,159,95,0,1677,75625,73694,a,55
56,193,76238,69,0,379,76879,76238,c,56
57,51,63,76782,0,151,77047,76782,g,57
58,143,114,187,0,76680,77124,76680,t,58
59,76530,235,163,0,1685,78613,76530,a,59
60,80,81,79397,0,473,80031,79397,g,60
61,186,173,208,0,79990,80557,79990,t,61
62,71,107,123,0,80862,81163,80862,t,62
63,224,80666,49,0,614,81553,80666,c,63
64,112,59,81,0,81659,81911,81659,t,64
65,81414,106,153,0,394,82067,81414,a,65
66,81438,217,163,0,850,82668,81438,a,66
67,152,82465,222,0,385,83224,82465,c,67
68,82641,160,287,0,1804,84892,82641,a,68
69,164,29,85393,0,371,85957,85393,g,69
70,152,107,116,0,85691,86066,85691,t,70
71,84,58,158,0,87300,87600,87300,t,71
72,118,58,102,0,88589,88867,88589,t,72
73,50,84,108,0,88979,89221,88979,t,73
74,24,79,125,0,89211,89439,89211,t,74
75,43,57,83,0,89566,89749,89566,t,75
76,89186,155,318,0,515,90174,89186,a,76
77,89921,188,80,0,212,90401,89921,a,77
78,29,203,163,0,90150,90545,90150,t,78
79,35,113,113,0,90553,90814,90553,t,79
80,90267,210,298,0,216,90991,90267,a,80
81,77,70,90762,0,274,91183,90762,g,81
82,90791,251,91,0,367,91500,90791,a,82
83,74,75,91278,0,2116,93543,91278,g,83
84,93678,193,165,0,1347,95383,93678,a,84
85,51,84,95289,0,1344,96768,95289,g,85
86,213,96782,122,0,347,97464,96782,c,86
87,97097,210,153,0,244,97704,97097,a,87
88,45,53,97536,0,241,97875,97536,g,88
89,97256,318,136,0,354,98064,97256,a,89
90,130,228,131,0,101326,101815,101326,t,90
91,257,102595,265,0,777,103894,102595,c,91
92,103,73,85,0,105391,105652,105391,t,92
93,177,105495,279,0,1730,107681,105495,c,93
94,86,90,118,0,108371,108665,108371,t,94
95,59,48,108543,0,275,108925,108543,g,95
96,107524,448,154,0,2384,110510,107524,a,96
97,52,95,92,0,112703,112942,112703,t,97
98,78,97,111422,0,342,111939,111422,g,98
99,111035,293,101,0,380,111809,111035,a,99
100,110996,385,202,0,907,112490,110996,a,100
101,97,81,78,0,113158,113414,113158,t,101
102,112434,204,192,0,492,113322,112434,a,102
103,112684,293,190,0,579,113746,112684,a,103
104,227,113386,133,0,768,114514,113386,c,104
105,392,113674,191,0,634,114891,113674,c,105
106,113951,232,312,0,260,114755,113951,a,106
107,113492,240,230,0,2634,116596,113492,a,107
108,284,117485,121,0,1926,119816,117485,c,108
109,325,79,119029,0,1619,121052,119029,g,109
110,120753,329,465,0,1925,123472,120753,a,110
111,123601,448,240,0,611,124900,123601,a,111
112,124137,490,156,0,618,125401,124137,a,112
113,124798,298,258,0,370,125724,124798,a,113
114,124746,507,287,0,307,125847,124746,a,114
115,125110,390,136,0,525,126161,125110,a,115
116,124,190,125587,0,2789,128690,125587,g,116
117,293,129,128859,0,1462,130743,128859,g,117
118,397,130480,146,0,1970,132993,130480,c,118
119,101,120,133097,0,355,133673,133097,g,119
120,132522,407,177,0,1034,134140,132522,a,120
121,134,60,134107,0,344,134645,134107,g,121
122,133777,275,214,0,575,134841,133777,a,122
123,134047,423,168,0,667,135305,134047,a,123
124,134459,490,182,0,507,135638,134459,a,124
125,124,122,183,0,135900,136329,135900,t,125
126,135330,309,235,0,3633,139507,135330,a,126
127,322,140484,259,0,2358,143423,140484,c,127
128,123,126,144373,0,1209,145831,144373,g,128
129,449,145471,246,0,1868,148034,145471,c,129
130,527,147717,260,0,1154,149658,147717,c,130
131,138,94,85,0,149724,150041,149724,t,131
132,81,58,141,0,149809,150089,149809,t,132
133,164,118,108,0,149746,150136,149746,t,133
134,346,149449,118,0,272,150185,149449,c,134
135,149485,230,260,0,330,150305,149485,a,135
136,149174,502,253,0,423,150352,149174,a,136
137,77,60,184,0,150306,150627,150306,t,137
138,149888,284,220,0,536,150928,149888,a,138
139,126,41,89,0,151520,151776,151520,t,139
140,118,71,151840,0,1740,153769,151840,g,140
141,336,153970,117,0,1205,155628,153970,c,141
142,127,167,111,0,155731,156136,155731,t,142
143,132,293,154404,0,360,155189,154404,g,143
144,154076,438,111,0,364,154989,154076,a,144
145,153971,516,327,0,267,155081,153971,a,145
146,154342,488,110,0,1175,156115,154342,a,146
147,356,156081,72,0,878,157387,156081,c,147
148,182,116,156581,0,1016,157895,156581,g,148
149,423,157426,188,0,924,158961,157426,c,149
150,254,144,158385,0,1455,160238,158385,g,150
151,158721,516,156,0,2152,161545,158721,a,151
152,210,169,161724,0,768,162871,161724,g,152
153,158264,632,118,0,1708,160722,158264,a,153
154,175,83,160914,0,938,162110,160914,g,154
155,161645,464,75,0,528,162712,161645,a,155
156,162079,416,73,0,983,163551,162079,a,156
157,162789,466,238,0,1075,164568,162789,a,157
158,548,163947,60,0,5933,170488,163947,c,158
159,833,171993,162,0,211,173199,171993,c,159
160,201,131,172769,0,552,173653,172769,g,160
161,530,172928,186,0,397,174041,172928,c,161
162,149,87,173493,0,268,173997,173493,g,162
163,510,231,199,0,173458,174398,173458,t,163
164,217,105,173936,0,361,174619,173936,g,164
165,455,256,163,0,175389,176263,175389,t,165
166,680,176129,116,0,842,177767,176129,c,166
167,229,121,177406,0,772,178528,177406,g,167
168,176721,836,204,0,1389,179150,176721,a,168
169,553,178846,154,0,1182,180735,178846,c,169
170,427,172,203,0,179951,180753,179951,t,170
171,176,91,180357,0,429,181053,180357,g,171
172,506,257,209,0,179868,180840,179868,t,172
173,179596,342,182,0,1972,182092,179596,a,173
174,498,181849,299,0,338,182984,181849,c,174
175,181030,469,107,0,353,181959,181030,a,175
176,180761,765,229,0,1495,183250,180761,a,176
177,819,182140,752,0,1025,184736,182140,c,177
178,184038,638,188,0,452,185316,184038,a,178
179,317,230,184552,0,1358,186457,184552,g,179
180,837,185681,158,0,916,187592,185681,c,180
181,584,186,350,0,187048,188168,187048,t,181
182,225,149,187585,0,289,188248,187585,g,182
183,186098,897,599,0,1488,189082,186098,a,183
184,937,187602,847,0,532,189918,187602,c,184
185,188944,467,209,0,1081,190701,188944,a,185
186,190082,769,191,0,952,191994,190082,a,186
187,190892,1139,107,0,1525,193663,190892,a,187
188,717,276,193142,0,380,194515,193142,g,188
189,192985,1123,216,0,669,194993,192985,a,189
190,362,177,194571,0,1188,196298,194571,g,190
191,194563,1032,318,0,1128,197041,194563,a,191
192,548,179,837,0,197632,199196,197632,t,192
193,299,172,181,0,205140,205792,205140,t,193
194,1562,207037,171,0,576,209346,207037,c,194
195,700,550,861,0,208218,210329,208218,t,195
196,1821,208198,353,0,1142,211514,208198,c,196
197,209043,709,941,0,3199,213892,209043,a,197
198,1577,211359,406,0,813,214155,211359,c,198
199,521,200,386,0,211344,212451,211344,t,199
200,359,2195,669,0,209329,212552,209329,t,200
201,247,138,211838,0,462,212685,211838,g,201
202,404,177,211336,0,523,212440,211336,g,202
203,209837,1357,499,0,496,212189,209837,a,203
204,209576,1370,628,0,501,212075,209576,a,204
205,890,363,729,0,210992,212974,210992,t,205
206,590,1478,210701,0,1016,213785,210701,g,206
207,1146,210471,1958,0,607,214182,210471,c,207
208,820,753,635,0,212406,214614,212406,t,208
209,814,325,212185,0,1068,214392,212185,g,209
210,2296,202486,931,0,2669,208382,202486,c,210
211,205386,1205,878,0,1681,209150,205386,a,211
212,1209,1337,205487,0,829,208862,205487,g,212
213,2018,692,200303,0,912,203925,200303,g,213
214,1192,383,200906,0,920,203401,200906,g,214
215,198242,1691,604,0,2264,202801,198242,a,215
216,7033,193381,1276,0,1228,202918,193381,c,216
217,1054,697,197482,0,750,199983,197482,g,217
218,194756,1528,1040,0,3545,200869,194756,a,218
219,2672,448,197616,0,1670,202406,197616,g,219
220,1908,2839,191977,0,1129,197853,191977,g,220
221,186374,1164,3411,0,2491,193440,186374,a,221
222,2382,182520,3214,0,3726,191842,182520,c,222
223,2035,179443,3204,0,2428,187110,179443,c,223
224,178543,870,5850,0,1823,187086,178543,a,224
225,625,282,3011,0,183693,187611,183693,t,225
226,2439,1471,1798,0,182960,188668,182960,t,226
227,185362,750,1374,0,2836,190322,185362,a,227
228,188083,874,1741,0,1078,191776,188083,a,228
229,186864,940,3179,0,537,191520,186864,a,229
230,188765,850,1034,0,1109,191758,188765,a,230
231,1129,185213,4699,0,1365,192406,185213,c,231
232,1893,900,488,0,191617,194898,191617,t,232
233,284,222,195413,0,580,196499,195413,g,233
234,718,333,502,0,194845,196398,194845,t,234
235,2391,297,1536,0,191928,196152,191928,t,235
236,927,191529,2438,0,1478,196372,191529,c,236
237,194759,620,365,0,658,196402,194759,a,237
238,542,358,1279,0,194127,196306,194127,t,238
239,882,1819,193048,0,1062,196811,193048,g,239
240,569,273,193819,0,3094,197755,193819,g,240
241,1561,195304,430,0,1127,198422,195304,c,241
242,2124,194249,1347,0,1369,199089,194249,c,242
243,1502,196159,1261,0,741,199663,196159,c,243
244,385,241,729,0,199154,200509,199154,t,244
245,694,267,199309,0,1394,201664,199309,g,245
246,404,289,200639,0,802,202134,200639,g,246
247,1201,699,610,0,201423,203933,201423,t,247
248,359,756,203065,0,851,205031,203065,g,248
249,342,317,203823,0,1587,206069,203823,g,249
250,1074,203463,346,0,3090,207973,203463,c,250
251,205,351,207870,0,307,208733,207870,g,251
252,612,271,344,0,207407,208634,207407,t,252
253,250,121,207,0,208535,209113,208535,t,253
254,1021,207736,140,0,2485,211382,207736,c,254
255,942,210469,145,0,863,212419,210469,c,255
256,220,174,242,0,211338,211974,211338,t,256
257,205,126,208,0,211655,212194,211655,t,257
258,746,211023,177,0,1799,213745,211023,c,258
259,256,109,213162,0,246,213773,213162,g,259
260,616,308,641,0,209396,210961,209396,t,260
261,636,164,419,0,209821,211040,209821,t,261
262,289,137,187,0,210542,211155,210542,t,262
263,822,207367,260,0,913,209362,207367,c,263
264,1128,206688,1157,0,1400,210373,206688,c,264
265,432,150,1208,0,208310,210100,208310,t,265
266,206736,897,418,0,218,208269,206736,a,266
267,203970,914,435,0,663,205982,203970,a,267
268,1289,202612,1321,0,647,205869,202612,c,268
269,203112,742,1354,0,1272,206480,203112,a,269
270,204152,924,1214,0,704,206994,204152,a,270
271,885,612,722,0,207060,209279,207060,t,271
272,1697,206715,599,0,866,209877,206715,c,272
273,1841,204768,2345,0,3418,212372,204768,c,273
274,1574,207511,2299,0,777,212161,207511,c,274
275,206034,1103,1314,0,1689,210140,206034,a,275
276,2553,203278,1438,0,2686,209955,203278,c,276
277,1551,200158,4483,0,430,206622,200158,c,277
278,203973,968,779,0,715,206435,203973,a,278
279,201954,1494,1550,0,2367,207365,201954,a,279
280,1186,202877,3513,0,3235,210811,202877,c,280
281,207298,1257,1803,0,1748,212106,207298,a,281
282,533,373,210335,0,4055,215296,210335,g,282
283,2149,211982,369,0,2143,216643,211982,c,283
284,212641,1825,1048,0,5004,220518,212641,a,284
285,578,365,220203,0,2342,223488,220203,g,285
286,1434,581,220143,0,557,222715,220143,g,286
287,687,473,220568,0,737,222465,220568,g,287
288,218033,2065,764,0,517,221379,218033,a,288
289,2825,424,2595,0,215438,221282,215438,t,289
290,218186,1485,215,0,946,220832,218186,a,290
291,995,214829,4090,0,1634,221548,214829,c,291
292,1291,483,1364,0,219329,222467,219329,t,292
293,230,172,221352,0,334,222088,221352,g,293
294,215100,1933,505,0,3668,221206,215100,a,294
295,217275,2095,1038,0,585,220993,217275,a,295
296,720,280,218511,0,1258,220769,218511,g,296
297,210025,2113,587,0,679,213404,210025,a,297
298,421,198,210849,0,1680,213148,210849,g,298
299,205176,3100,1183,0,1269,210728,205176,a,299
300,952,906,725,0,209678,212261,209678,t,300
301,1752,3367,205011,0,1806,211936,205011,g,301
302,751,1201,204889,0,3067,209908,204889,g,302
303,795,428,207589,0,9911,218723,207589,g,303
304,2300,546,215654,0,1523,220023,215654,g,304
305,215896,1671,1255,0,796,219618,215896,a,305
306,215033,1163,1755,0,1520,219471,215033,a,306
307,2294,213593,2746,0,773,219406,213593,c,307
308,213914,1202,2860,0,343,218319,213914,a,308
309,211743,1653,2853,0,1268,217517,211743,a,309
310,317,929,3132,0,212679,217057,212679,t,310
311,599,450,2226,0,218373,221648,218373,t,311
312,220443,1095,977,0,2107,224622,220443,a,312
313,221734,913,1641,0,673,224961,221734,a,313
314,221930,774,1531,0,766,225001,221930,a,314
315,221393,1202,1998,0,330,224923,221393,a,315
316,221594,922,871,0,1392,224779,221594,a,316
317,220365,2058,1194,0,520,224137,220365,a,317
318,447,205,1054,0,221899,223605,221899,t,318
319,1257,219321,1422,0,496,222496,219321,c,319
320,217773,583,1885,0,868,221109,217773,a,320
321,215354,933,1421,0,381,218089,215354,a,321
322,214928,1115,1470,0,714,218227,214928,a,322
323,215394,1267,586,0,779,218026,215394,a,323
324,965,517,214208,0,1147,216837,214208,g,324
325,2629,212277,774,0,1022,216702,212277,c,325
326,1431,211710,2290,0,782,216213,211710,c,326
327,210799,1886,973,0,467,214125,210799,a,327
328,984,216,2136,0,209463,212799,209463,t,328
329,825,304,1124,0,210618,212871,210618,t,329
330,209811,1730,555,0,595,212691,209811,a,330
331,208601,1407,2108,0,460,212576,208601,a,331
332,585,786,632,0,217244,219247,217244,t,332
333,332,406,222013,0,1432,224183,222013,g,333
334,1243,599,679,0,221980,224501,221980,t,334
335,1672,874,880,0,221386,224812,221386,t,335
336,599,399,2197,0,222422,225617,222422,t,336
337,949,333,1648,0,223853,226783,223853,t,337
338,999,264,224046,0,1234,226543,224046,g,338
339,219934,1080,437,0,911,222362,219934,a,339
340,1473,224,220033,0,442,222172,220033,g,340
341,216672,1172,458,0,746,219048,216672,a,341
342,574,603,216811,0,648,218636,216811,g,342
343,1319,1680,214471,0,2497,219967,214471,g,343
344,557,292,218992,0,930,220771,218992,g,344
345,2335,709,1251,0,216233,220528,216233,t,345
346,1421,530,1589,0,218211,221751,218211,t,346
347,3130,216269,1364,0,2036,222799,216269,c,347
348,218616,928,2397,0,1017,222958,218616,a,348
349,404,309,221380,0,3894,225987,221380,g,349
350,1110,650,223428,0,960,226148,223428,g,350
351,221314,1101,1484,0,4165,228064,221314,a,351
352,226319,1165,610,0,4084,232178,226319,a,352
353,230966,1245,343,0,1117,233671,230966,a,353
354,667,177,232090,0,769,233703,232090,g,354
355,229214,1231,249,0,1322,232016,229214,a,355
356,425,137,230955,0,6932,238449,230955,g,356
357,235497,1692,366,0,2152,239707,235497,a,357
358,608,254,2543,0,238237,241642,238237,t,358
359,457,1378,520,0,238693,241048,238693,t,359
360,1882,569,237011,0,853,240315,237011,g,360
361,818,182,235870,0,588,237458,235870,g,361
362,232037,736,596,0,1045,234414,232037,a,362
363,229527,1310,1005,0,2840,234682,229527,a,363
364,2430,1148,227933,0,453,231964,227933,g,364
365,1186,342,229260,0,1254,232042,229260,g,365
366,227564,1428,1059,0,1616,231667,227564,a,366
367,1094,1081,1366,0,230459,234000,230459,t,367
368,820,412,232946,0,1094,235272,232946,g,368
369,2747,229595,1465,0,3698,237505,229595,c,369
370,2087,752,1429,0,234935,239203,234935,t,370
371,559,545,237342,0,913,239359,237342,g,371
372,235120,733,682,0,1396,237931,235120,a,372
373,234492,723,1851,0,911,237977,234492,a,373
374,1280,233914,1830,0,1202,238226,233914,c,374
375,233289,636,2227,0,462,236614,233289,a,375
376,249,250,1087,0,240354,241940,240354,t,376
377,1344,242150,629,0,390,244513,242150,c,377
378,292,183,2628,0,241319,244422,241319,t,378
379,640,967,395,0,243813,245815,243813,t,379
380,357,157,244879,0,571,245964,244879,g,380
381,240454,541,938,0,2038,243971,240454,a,381
382,241089,598,884,0,1519,244090,241089,a,382
383,1731,239528,1880,0,1405,244544,239528,c,383
384,238573,845,1683,0,811,241912,238573,a,384
385,859,179,240145,0,830,242013,240145,g,385
386,1508,302,239234,0,961,242005,239234,g,386
387,238525,1032,802,0,1738,242097,238525,a,387
388,1693,352,238623,0,1211,241879,238623,g,388
389,230260,1473,664,0,5666,238063,230260,a,389
390,1649,233719,3369,0,1845,240582,233719,c,390
391,894,223,238322,0,3795,243234,238322,g,391
392,3510,238012,866,0,2097,244485,238012,c,392
393,240698,1206,982,0,820,243706,240698,a,393
394,862,175,239686,0,365,241088,239686,g,394
395,237938,731,610,0,818,240097,237938,a,395
396,234611,909,2654,0,2764,240938,234611,a,396
397,1054,238478,1267,0,492,241291,238478,c,397
398,686,342,1042,0,238414,240484,238414,t,398
399,1319,342,238085,0,1258,241004,238085,g,399
400,1778,235380,727,0,3136,241021,235380,c,400
401,237806,832,1026,0,1098,240762,237806,a,401
402,761,537,236714,0,981,238993,236714,g,402
403,1986,267,225238,0,1226,228717,225238,g,403
404,1836,217593,5728,0,1311,226468,217593,c,404
405,219474,676,873,0,2884,223907,219474,a,405
406,4332,388,867,0,219679,225266,219679,t,406
407,537,389,224963,0,549,226438,224963,g,407
408,221546,929,937,0,1549,224961,221546,a,408
409,2934,379,3415,0,218528,225256,218528,t,409
410,1645,220714,2153,0,1154,225666,220714,c,410
411,219759,777,3918,0,961,225415,219759,a,411
412,623,483,2444,0,221740,225290,221740,t,412
413,1493,3496,741,0,219464,225194,219464,t,413
414,219281,804,3719,0,1513,225317,219281,a,414
415,612,950,1291,0,227492,230345,227492,t,415
416,616,1359,229705,0,916,232596,229705,g,416
417,1259,225945,2973,0,2433,232610,225945,c,417
418,2585,381,753,0,228630,232349,228630,t,418
419,531,213,230192,0,697,231633,230192,g,419
420,227794,1170,1189,0,758,230911,227794,a,420
421,688,230,2585,0,226978,230481,226978,t,421
422,769,870,1656,0,226940,230235,226940,t,422
423,1364,225539,2084,0,1325,230312,225539,c,423
424,3005,225634,755,0,674,230068,225634,c,424
425,228397,322,738,0,360,229817,228397,a,425
426,227487,754,748,0,1306,230295,227487,a,426
427,1417,226451,1963,0,575,230406,226451,c,427
428,226557,699,420,0,1150,228826,226557,a,428
429,232,180,228035,0,1211,229658,228035,g,429
430,1317,596,765,0,227689,230367,227689,t,430
431,377,191,229366,0,647,230581,229366,g,431
432,227832,1071,412,0,4424,233739,227832,a,432
433,1107,338,314,0,234552,236311,234552,t,433
434,514,888,235037,0,662,237101,235037,g,434
435,760,344,234576,0,1110,236790,234576,g,435
436,1302,234265,160,0,7235,242962,234265,c,436
437,324,286,245208,0,1032,246850,245208,g,437
438,776,297,866,0,244802,246741,244802,t,438
439,361,231,466,0,245489,246547,245489,t,439
440,1184,243677,490,0,987,246338,243677,c,440
441,1262,243425,817,0,1792,247296,243425,c,441
442,245109,815,595,0,1674,248193,245109,a,442
443,549,177,677,0,245489,246892,245489,t,443
444,916,436,818,0,244147,246317,244147,t,444
445,446,156,951,0,244359,245912,244359,t,445
446,242283,898,608,0,773,244562,242283,a,446
447,242116,921,998,0,862,244897,242116,a,447
448,1124,242073,643,0,1810,245650,242073,c,448
449,3381,234574,1150,0,368,239473,234574,c,449
450,235809,652,1796,0,1864,240121,235809,a,450
451,2282,235664,1666,0,555,240167,235664,c,451
452,236036,1114,873,0,1710,239733,236036,a,452
453,965,237578,359,0,1586,240488,237578,c,453
454,731,154,238435,0,291,239611,238435,g,454
455,733,283,2042,0,235344,238402,235344,t,455
456,235821,1243,786,0,582,238432,235821,a,456
457,234520,1139,1017,0,7587,244263,234520,a,457
458,1381,244312,1175,0,2860,249728,244312,c,458
459,1487,282,242784,0,888,245441,242784,g,459
460,911,300,242339,0,1123,244673,242339,g,460
461,240274,1592,1188,0,1449,244503,240274,a,461
462,1779,327,242074,0,969,245149,242074,g,462
463,239396,1214,712,0,1556,242878,239396,a,463
464,238582,1299,1477,0,2775,244133,238582,a,464
465,2294,238533,1849,0,4472,247148,238533,c,465
466,3880,237008,3502,0,862,245252,237008,c,466
467,239425,708,2468,0,3658,246259,239425,a,467
468,2604,241027,1881,0,1481,246993,241027,c,468
469,238887,699,3179,0,3358,246123,238887,a,469
470,1321,237757,5442,0,1444,245964,237757,c,470
471,241546,948,1540,0,1750,245784,241546,a,471
472,3754,248,1701,0,240055,245758,240055,t,472
473,920,1304,242762,0,1492,246478,242762,g,473
474,242229,1145,1557,0,1042,245973,242229,a,474
475,1839,472,3460,0,244107,249878,244107,t,475
476,1667,248280,719,0,1860,252526,248280,c,476
477,439,173,250887,0,592,252091,250887,g,477
478,1210,481,1083,0,249001,251775,249001,t,478
479,2090,246937,1465,0,1236,251728,246937,c,479
480,245401,1257,1827,0,2906,251391,245401,a,480
481,762,413,248613,0,802,250590,248613,g,481
482,1460,558,979,0,246731,249728,246731,t,482
483,245854,1390,1311,0,971,249526,245854,a,483
484,818,424,247806,0,584,249632,247806,g,484
485,242257,1272,2367,0,1795,247691,242257,a,485
486,2884,240434,3069,0,729,247116,240434,c,486
487,242521,1186,1029,0,1700,246436,242521,a,487
488,242672,1788,564,0,2355,247379,242672,a,488
489,821,711,245230,0,1286,248048,245230,g,489
490,238739,2091,1111,0,2139,244080,238739,a,490
491,696,261,242652,0,1012,244621,242652,g,491
492,222653,2050,1108,0,1713,227524,222653,a,492
493,220325,1686,3207,0,2723,227941,220325,a,493
494,217587,2833,857,0,6275,227552,217587,a,494
495,1016,4839,218005,0,7092,230952,218005,g,495
496,2263,1147,219075,0,7061,229546,219075,g,496
497,1817,578,225841,0,2355,230591,225841,g,497
498,225569,1860,1543,0,2677,231649,225569,a,498
499,225983,1684,2091,0,1803,231561,225983,a,499
500,219306,2081,7795,0,1270,230452,219306,a,500
501,225474,1875,1666,0,2026,231041,225474,a,501
502,1009,480,228907,0,586,230982,228907,g,502
503,2447,4150,1137,0,223074,230808,223074,t,503
504,1241,224764,4721,0,1823,232549,224764,c,504
505,500,588,3707,0,227910,232705,227910,t,505
506,708,3393,539,0,228240,232880,228240,t,506
507,1112,226271,4581,0,854,232818,226271,c,507
508,722,374,1000,0,230188,232284,230188,t,508
509,582,363,232612,0,1416,234973,232612,g,509
510,931,351,1247,0,232882,235411,232882,t,510
511,2028,318,4047,0,228503,234896,228503,t,511
512,710,399,3084,0,229724,233917,229724,t,512
513,229640,824,2398,0,637,233499,229640,a,513
514,230327,1208,1439,0,498,233472,230327,a,514
515,230919,1128,905,0,526,233478,230919,a,515
516,230787,1276,539,0,1151,233753,230787,a,516
517,1133,227767,4345,0,694,233939,227767,c,517
518,231072,914,394,0,1127,233507,231072,a,518
519,350,244,232457,0,397,233448,232457,g,519
520,227405,1320,432,0,4334,233491,227405,a,520
521,1101,391,231651,0,843,233986,231651,g,521
522,580,404,231270,0,1355,233609,231270,g,522
523,230277,1638,711,0,860,233486,230277,a,523
524,717,471,647,0,231615,233450,231615,t,524
525,961,2341,229116,0,2138,234556,229116,g,525
526,752,513,231734,0,4167,237166,231734,g,526
527,2039,2071,846,0,237855,242811,237855,t,527
528,580,715,244118,0,5342,250755,244118,g,528
529,1348,596,1966,0,249897,253807,249897,t,529
530,616,502,251800,0,3121,256039,251800,g,530
531,254006,1698,601,0,336,256641,254006,a,531
532,253473,1300,818,0,2643,258234,253473,a,532
533,2353,254091,665,0,751,257860,254091,c,533
534,248375,1319,1136,0,1361,252191,248375,a,534
535,1310,698,1715,0,250482,254205,250482,t,535
536,975,539,253194,0,1519,256227,253194,g,536
537,2614,696,805,0,252021,256136,252021,t,537
538,1369,348,253991,0,559,256267,253991,g,538
539,2451,586,3592,0,239664,246293,239664,t,539
540,242429,646,1578,0,1294,245947,242429,a,540
541,3715,234715,4311,0,1586,244327,234715,c,541
542,2379,237387,1588,0,7529,248883,237387,c,542
543,2683,243173,4859,0,513,251228,243173,c,543
544,2289,552,2568,0,242367,247776,242367,t,544
545,2243,240511,3356,0,676,246786,240511,c,545
546,240846,1376,3183,0,1110,246515,240846,a,546
547,2719,613,2402,0,238995,244729,238995,t,547
548,1885,2108,238428,0,940,243361,238428,g,548
549,3278,479,232877,0,1928,238562,232877,g,549
550,3026,227536,4943,0,2954,238459,227536,c,550
551,5054,228962,3261,0,1735,239012,228962,c,551
552,231526,1415,3362,0,3068,239371,231526,a,552
553,2939,1241,1702,0,233100,238982,233100,t,553
554,4545,1656,230989,0,645,237835,230989,g,554
555,1079,476,235356,0,915,237826,235356,g,555
556,233629,818,878,0,1996,237321,233629,a,556
557,2256,227375,3956,0,3540,237127,227375,c,557
558,2634,231558,1792,0,1041,237025,231558,c,558
559,759,375,4113,0,231159,236406,231159,t,559
560,1561,2167,771,0,237313,241812,237313,t,560
561,1268,3287,238854,0,4666,248075,238854,g,561
562,665,317,247415,0,640,249037,247415,g,562
563,3689,1287,2849,0,238152,245977,238152,t,563
564,1132,415,243462,0,663,245672,243462,g,564
565,239332,1394,1664,0,2595,244985,239332,a,565
566,241332,1476,1101,0,1004,244913,241332,a,566
567,1663,540,3329,0,238604,244136,238604,t,567
568,2762,1521,1856,0,237929,244068,237929,t,568
569,402,320,242603,0,2176,245501,242603,g,569
570,3293,796,751,0,241649,246489,241649,t,570
571,971,317,245214,0,6622,253124,245214,g,571
572,1755,416,821,0,252398,255390,252398,t,572
573,1457,268,252349,0,779,254853,252349,g,573
574,250035,1035,1001,0,2379,254450,250035,a,574
575,251582,1244,1207,0,1688,255721,251582,a,575
576,815,635,253852,0,2109,257411,253852,g,576
577,253547,1282,1085,0,736,256650,253547,a,577
578,844,327,974,0,254570,256715,254570,t,578
579,252493,1983,799,0,6454,261729,252493,a,579
580,1502,259416,1319,0,1583,263820,259416,c,580
581,260777,1230,1284,0,4184,267475,260777,a,581
582,265579,1074,1581,0,678,268912,265579,a,582
583,872,405,904,0,269039,271220,269039,t,583
584,1654,269279,809,0,720,272462,269279,c,584
585,268480,1558,1096,0,2189,273323,268480,a,585
586,1293,271153,623,0,2933,276002,271153,c,586
587,415,229,276100,0,1225,277969,276100,g,587
588,1110,596,805,0,275393,277904,275393,t,588
589,275336,1102,509,0,2255,279202,275336,a,589
590,1909,275973,666,0,637,279185,275973,c,590
591,276463,1428,621,0,550,279062,276463,a,591
592,275665,1884,492,0,1150,279191,275665,a,592
593,445,366,278246,0,689,279746,278246,g,593
594,1416,687,589,0,280429,283121,280429,t,594
595,364,276,283742,0,883,285265,283742,g,595
596,884,487,642,0,283715,285728,283715,t,596
597,1234,282867,617,0,5817,290535,282867,c,597
598,1373,289756,710,0,1217,293056,289756,c,598
599,882,162,419,0,290456,291919,290456,t,599
600,271,219,949,0,290236,291675,290236,t,600
601,981,307,371,0,289947,291606,289947,t,601
602,441,271,409,0,293251,294372,293251,t,602
603,1565,291842,620,0,1179,295206,291842,c,603
604,1909,333,658,0,286783,289683,286783,t,604
605,1445,283783,1975,0,1192,288395,283783,c,605
606,281608,1494,946,0,3655,287703,281608,a,606
607,721,226,286761,0,1848,289556,286761,g,607
608,1135,535,286817,0,1079,289566,286817,g,608
609,3498,283590,775,0,1229,289092,283590,c,609
610,285375,1452,944,0,1224,288995,285375,a,610
611,403,121,287889,0,871,289284,287889,g,611
612,285756,1570,970,0,724,289020,285756,a,612
613,283442,1750,2923,0,868,288983,283442,a,613
614,1097,1575,734,0,285510,288916,285510,t,614
615,704,280,286531,0,673,288188,286531,g,615
616,281305,1116,1353,0,1709,285483,281305,a,616
617,282023,1150,914,0,2539,286626,282023,a,617
618,1525,281914,1483,0,2322,287244,281914,c,618
619,2381,262912,3394,0,6569,275256,262912,c,619
620,266240,839,6676,0,4519,278274,266240,a,620
621,1617,327,276272,0,1944,280160,276272,g,621
622,271578,1333,299,0,2620,275830,271578,a,622
623,271499,2124,1087,0,1668,276378,271499,a,623
624,1428,525,272263,0,677,274893,272263,g,624
625,268475,1142,3575,0,6059,279251,268475,a,625
626,2197,271087,5813,0,4009,283106,271087,c,626
627,276132,1816,4475,0,1026,283449,276132,a,627
628,4498,348,1975,0,281557,288378,281557,t,628
629,284372,3633,681,0,5286,293972,284372,a,629
630,1510,544,291991,0,1486,295531,291991,g,630
631,289336,2079,1172,0,1595,294182,289336,a,631
632,897,286,6376,0,287640,295199,287640,t,632
633,844,1467,608,0,295393,298312,295393,t,633
634,1334,775,295371,0,813,298293,295371,g,634
635,1335,459,1749,0,294268,297811,294268,t,635
636,3977,1296,1395,0,290817,297485,290817,t,636
637,971,495,293206,0,2485,297157,293206,g,637
638,2124,419,284769,0,3807,291119,284769,g,638
639,2649,966,1917,0,285448,290980,285448,t,639
640,1304,1532,286546,0,1550,290932,286546,g,640
641,2300,281548,1570,0,3459,288877,281548,c,641
642,283877,1346,1770,0,547,287540,283877,a,642
643,281280,1126,3113,0,2463,287982,281280,a,643
644,3439,282326,1767,0,3495,291027,282326,c,644
645,1005,297,947,0,290391,292640,290391,t,645
646,942,287999,2790,0,1144,292875,287999,c,646
647,1099,385,1270,0,289933,292687,289933,t,647
648,288275,1866,877,0,1556,292574,288275,a,648
649,984,288409,2456,0,1222,293071,288409,c,649
650,1075,242,291398,0,504,293219,291398,g,650
651,605,346,1080,0,290597,292628,290597,t,651
652,1916,288658,996,0,1677,293247,288658,c,652
653,2595,288143,1403,0,1102,293243,288143,c,653
654,290025,1100,415,0,1339,292879,290025,a,654
655,1301,289023,1897,0,411,292632,289023,c,655
656,289154,1229,749,0,954,292086,289154,a,656
657,1185,366,501,0,291601,293653,291601,t,657
658,320,540,291675,0,2263,294798,291675,g,658
659,404,206,293796,0,3789,298195,293796,g,659
660,602,242,298202,0,535,299581,298202,g,660
661,2021,740,681,0,295820,299262,295820,t,661
662,297624,954,364,0,404,299346,297624,a,662
663,297184,907,582,0,3240,301913,297184,a,663
664,1312,301140,480,0,613,303545,301140,c,664
665,558,175,696,0,301732,303161,301732,t,665
666,325,303,457,0,301424,302509,301424,t,666
667,300621,883,475,0,1264,303243,300621,a,667
668,419,461,324,0,306752,307956,306752,t,668
669,476,426,308466,0,514,309882,308466,g,669
670,661,363,306413,0,904,308341,306413,g,670
671,762,228,305693,0,506,307189,305693,g,671
672,304702,1178,251,0,1535,307666,304702,a,672
673,1588,305807,234,0,884,308513,305807,c,673
674,379,304,307500,0,1038,309221,307500,g,674
675,904,396,683,0,308173,310156,308173,t,675
676,335,205,307965,0,925,309430,307965,g,676
677,733,321,291,0,307709,309054,307709,t,677
678,307595,677,416,0,892,309580,307595,a,678
679,1389,306464,1063,0,1322,310238,306464,c,679
680,1893,306764,1001,0,465,310123,306764,c,680
681,306384,1020,1006,0,1087,309497,306384,a,681
682,1799,306650,692,0,1810,310951,306650,c,682
683,2711,307077,636,0,342,310766,307077,c,683
684,307419,1206,536,0,1872,311033,307419,a,684
685,1627,307943,1028,0,576,311174,307943,c,685
686,306019,1521,1109,0,2453,311102,306019,a,686
687,745,245,310425,0,694,312109,310425,g,687
688,1877,658,306637,0,2010,311182,306637,g,688
689,307452,1883,869,0,727,310931,307452,a,689
690,1321,395,308650,0,658,311024,308650,g,690
691,299690,1763,244,0,452,302149,299690,a,691
692,294372,1438,4957,0,1888,302655,294372,a,692
693,4826,295635,1280,0,908,302649,295635,c,693
694,289660,2060,1248,0,5202,298170,289660,a,694
695,1743,292556,3006,0,1688,298993,292556,c,695
696,285904,2169,5117,0,1673,294863,285904,a,696
697,774,295,291128,0,657,292854,291128,g,697
698,280835,2076,555,0,2341,285807,280835,a,698
699,281353,2098,555,0,996,285002,281353,a,699
700,702,718,282325,0,1153,284898,282325,g,700
701,273817,2050,3293,0,1743,280903,273817,a,701
702,1211,272,279116,0,4035,284634,279116,g,702
703,278771,2369,2314,0,2700,286154,278771,a,703
704,281536,1376,2680,0,4356,289948,281536,a,704
705,287541,1377,1699,0,2084,292701,287541,a,705
706,284340,1456,6448,0,673,292917,284340,a,706
707,287245,1267,3659,0,1141,293312,287245,a,707
708,289699,1515,1344,0,1275,293833,289699,a,708
709,863,761,290918,0,1804,294346,290918,g,709
710,279415,1645,1214,0,1802,284076,279415,a,710
711,1360,613,2525,0,279230,283728,279230,t,711
712,2266,275114,2349,0,2120,281849,275114,c,712
713,270989,1101,4769,0,5359,282218,270989,a,713
714,1305,1119,278598,0,1930,282952,278598,g,714
715,4086,2162,1905,0,274631,282784,274631,t,715
716,3050,1303,278115,0,776,283244,278115,g,716
717,2794,595,269283,0,2152,274824,269283,g,717
718,6496,260519,3964,0,2638,273617,260519,c,718
719,264280,2970,3481,0,4607,275338,264280,a,719
720,3439,266803,3071,0,569,273882,266803,c,720
721,2098,1739,2112,0,268895,274844,268895,t,721
722,2984,270451,864,0,4211,278510,270451,c,722
723,602,334,278956,0,428,280320,278956,g,723
724,3019,559,2820,0,273743,280141,273743,t,724
725,2018,481,3887,0,273454,279840,273454,t,725
726,2617,273869,1584,0,1826,279896,273869,c,726
727,2390,271877,4108,0,921,279296,271877,c,727
728,272356,1348,769,0,3103,277576,272356,a,728
729,1549,272974,1451,0,464,276438,272974,c,729
730,270763,1293,3324,0,354,275734,270763,a,730
731,814,227,442,0,275314,276797,275314,t,731
732,484,720,276038,0,1812,279054,276038,g,732
733,1392,671,481,0,277915,280459,277915,t,733
734,730,698,279339,0,711,281478,279339,g,734
735,601,196,279411,0,1160,281368,279411,g,735
736,769,198,279344,0,551,280862,279344,g,736
737,277195,1508,567,0,894,280164,277195,a,737
738,277700,1520,362,0,1747,281329,277700,a,738
739,2267,311,537,0,278603,281718,278603,t,739
740,718,686,279978,0,1236,282618,279978,g,740
741,2346,378,279700,0,718,283142,279700,g,741
742,948,314,281100,0,883,283245,281100,g,742
743,276945,1015,375,0,4474,282809,276945,a,743
744,1818,279427,1857,0,1635,284737,279427,c,744
745,1472,617,1153,0,280802,284044,280802,t,745
746,1568,279,282502,0,967,285316,282502,g,746
747,1503,288,281132,0,819,283742,281132,g,747
748,277982,2201,454,0,1414,282051,277982,a,748
749,1648,412,278186,0,833,281079,278186,g,749
750,262895,1710,658,0,16318,281581,262895,a,750
751,2034,278565,3715,0,2188,286502,278565,c,751
752,277325,2212,2775,0,1851,284163,277325,a,752
753,1763,275209,3134,0,3301,283407,275209,c,753
754,679,446,281720,0,344,283189,281720,g,754
755,269919,1403,919,0,3343,275584,269919,a,755
756,270559,1502,1719,0,4753,278533,270559,a,756
757,2112,268722,6929,0,1573,279336,268722,c,757
758,4025,1126,4944,0,267058,277153,267058,t,758
759,610,366,275298,0,323,276597,275298,g,759
760,269858,3581,1688,0,507,275634,269858,a,760
761,269687,1181,2775,0,295,273938,269687,a,761
762,265199,1368,967,0,4544,272078,265199,a,762
763,1626,263881,5565,0,712,271784,263881,c,763
764,256597,1171,3565,0,761,262094,256597,a,764
765,752,1956,3345,0,256065,262118,256065,t,765
766,2070,1932,256662,0,1196,261860,256662,g,766
767,871,373,253884,0,4190,259318,253884,g,767
768,247057,2155,593,0,2763,252568,247057,a,768
769,3160,2247,5047,0,242666,253120,242666,t,769
770,2566,1705,247222,0,463,251956,247222,g,770
771,2132,589,4104,0,244638,251463,244638,t,771
772,3385,243796,2452,0,1800,251433,243796,c,772
773,243085,1617,4614,0,1355,250671,243085,a,773
774,3187,412,2151,0,246201,251951,246201,t,774
775,2548,241367,3673,0,2020,249608,241367,c,775
776,241994,1296,4066,0,2820,250176,241994,a,776
777,696,289,245675,0,497,247157,245675,g,777
778,238529,1354,989,0,3062,243934,238529,a,778
779,239257,1622,2207,0,3798,246884,239257,a,779
780,2414,1119,241644,0,1405,246582,241644,g,780
781,2940,1582,237448,0,1497,243467,237448,g,781
782,2381,1020,237403,0,2048,242852,237403,g,782
783,2158,539,237802,0,2489,242988,237802,g,783
784,3162,234511,729,0,5892,244294,234511,c,784
785,3300,235963,3932,0,3207,246402,235963,c,785
786,744,606,2620,0,245105,249075,245105,t,786
787,1192,1244,247271,0,3026,252733,247271,g,787
788,832,242,250641,0,2031,253746,250641,g,788
789,250080,1231,1421,0,839,253571,250080,a,789
790,249873,998,1648,0,851,253370,249873,a,790
791,249972,1237,1053,0,2175,254437,249972,a,791
792,1848,248723,3080,0,1213,254864,248723,c,792
793,250537,1695,1430,0,339,254001,250537,a,793
794,1201,744,1448,0,249846,253239,249846,t,794
795,752,718,250948,0,700,253118,250948,g,795
796,2052,246488,1108,0,2036,251684,246488,c,796
797,2668,245308,2269,0,1647,251892,245308,c,797
798,2306,245035,1039,0,5392,253772,245035,c,798
799,251042,2320,1314,0,1594,256270,251042,a,799
800,816,420,255014,0,610,256860,255014,g,800
801,252300,1736,889,0,1747,256672,252300,a,801
802,875,248,254705,0,650,256478,254705,g,802
803,251392,1685,738,0,2784,256599,251392,a,803
804,254066,1255,1171,0,724,257216,254066,a,804
805,558,513,2167,0,256408,259646,256408,t,805
806,1106,443,1666,0,259024,262239,259024,t,806
807,832,342,260430,0,891,262495,260430,g,807
808,259311,1430,599,0,545,261885,259311,a,808
809,259610,969,966,0,408,261953,259610,a,809
810,258911,1147,557,0,5251,265866,258911,a,810
811,2233,263979,892,0,1020,268124,263979,c,811
812,1028,460,1778,0,264641,267907,264641,t,812
813,649,848,573,0,266145,268215,266145,t,813
814,1199,382,265991,0,684,268256,265991,g,814
815,633,257,264201,0,969,266060,264201,g,815
816,259114,1739,612,0,913,262378,259114,a,816
817,1315,372,1673,0,259410,262770,259410,t,817
818,2361,258712,891,0,865,262829,258712,c,818
819,660,223,1766,0,259817,262466,259817,t,819
820,873,1313,1292,0,260280,263758,260280,t,820
821,1549,429,262019,0,944,264941,262019,g,821
822,261042,1299,1407,0,642,264390,261042,a,822
823,1778,373,261414,0,541,264106,261414,g,823
824,260416,1250,898,0,712,263276,260416,a,824
825,1781,259032,1628,0,872,263313,259032,c,825
826,258866,1191,1241,0,861,262159,258866,a,826
827,771,284,986,0,262489,264530,262489,t,827
828,1848,262482,985,0,1753,267068,262482,c,828
829,2402,261708,1200,0,1127,266437,261708,c,829
830,261973,1293,1132,0,981,265379,261973,a,830
831,1053,469,263094,0,936,265552,263094,g,831
832,804,424,262532,0,2407,266167,262532,g,832
833,1898,259600,1355,0,2407,265260,259600,c,833
834,795,389,1174,0,262218,264576,262218,t,834
835,1071,272,827,0,262400,264570,262400,t,835
836,464,334,897,0,262882,264577,262882,t,836
837,259801,1321,962,0,3261,265345,259801,a,837
838,1503,260126,1947,0,3198,266774,260126,c,838
839,1581,259831,1577,0,1749,264738,259831,c,839
840,257208,1066,2591,0,1940,262805,257208,a,840
841,954,409,2202,0,259329,262894,259329,t,841
842,258240,1643,1352,0,1920,263155,258240,a,842
843,257125,1230,1526,0,3646,263527,257125,a,843
844,1050,1315,1471,0,261260,265096,261260,t,844
845,1328,477,260766,0,1995,264566,260766,g,845
846,1312,418,260179,0,8260,270169,260179,g,846
847,3060,266256,1605,0,2313,273234,266256,c,847
848,267201,1648,2329,0,1812,272990,267201,a,848
849,1181,431,269660,0,1310,272582,269660,g,849
850,3455,262823,2693,0,1497,270468,262823,c,850
851,264096,2277,2396,0,1394,270163,264096,a,851
852,263851,1348,2050,0,2898,270147,263851,a,852
853,1415,291,1604,0,266955,270265,266955,t,853
854,2155,264128,1426,0,6013,273722,264128,c,854
855,2023,267235,2784,0,3354,275396,267235,c,855
856,1705,1253,1671,0,270939,275568,270939,t,856
857,814,655,272542,0,1334,275345,272542,g,857
858,2074,351,265630,0,2329,270384,265630,g,858
859,2872,255521,3350,0,3190,264933,255521,c,859
860,246649,1635,2171,0,3656,254111,246649,a,860
861,2019,349,2538,0,248314,253220,248314,t,861
862,248665,1408,1172,0,3342,254587,248665,a,862
863,2412,244568,5103,0,2566,254649,244568,c,863
864,245506,2780,3033,0,1757,253076,245506,a,864
865,2131,242272,4346,0,4085,252834,242272,c,865
866,2497,244098,2127,0,3214,251936,244098,c,866
867,240116,2193,5152,0,3874,251335,240116,a,867
868,1734,454,2880,0,246687,251755,246687,t,868
869,242394,2909,2060,0,3662,251025,242394,a,869
870,2457,930,246410,0,3954,253751,246410,g,870
871,869,1017,245451,0,1994,249331,245451,g,871
872,242188,1910,2192,0,2414,248704,242188,a,872
873,239578,1817,3609,0,5040,250044,239578,a,873
874,3302,243614,1459,0,3870,252245,243614,c,874
875,851,803,245651,0,1474,248779,245651,g,875
876,237382,1852,2164,0,13828,255226,237382,a,876
877,3469,252143,2054,0,2762,260428,252143,c,877
878,244006,3111,4273,0,3599,254989,244006,a,878
879,2212,241880,5804,0,5923,255819,241880,c,879
880,243412,2362,4818,0,5437,256029,243412,a,880
881,924,511,1784,0,252429,255648,252429,t,881
882,3681,2893,1990,0,247026,255590,247026,t,882
883,593,365,5041,0,250222,256221,250222,t,883
884,1926,246708,5319,0,3524,257477,246708,c,884
885,3475,245165,6772,0,1938,257350,245165,c,885
886,249907,1310,3319,0,1215,255751,249907,a,886
887,244997,1503,2278,0,1955,250733,244997,a,887
888,245437,1578,2504,0,1078,250597,245437,a,888
889,1693,613,245017,0,1109,248432,245017,g,889
890,233996,2610,2266,0,2277,241149,233996,a,890
891,1184,877,236708,0,2220,240989,236708,g,891
892,4878,223729,2238,0,6346,237191,223729,c,892
893,2100,219769,6027,0,7848,235744,219769,c,893
894,1969,220642,4230,0,9571,236412,220642,c,894
895,4236,1312,5240,0,224924,235712,224924,t,895
896,610,262,230936,0,2844,234652,230936,g,896
897,221236,2409,2065,0,8114,233824,221236,a,897
898,4950,390,2170,0,227057,234567,227057,t,898
899,1351,2700,5553,0,224957,234561,224957,t,899
900,4254,359,1979,0,227353,233945,227353,t,900
901,1724,1643,4863,0,225077,233307,225077,t,901
902,2239,223531,4313,0,3071,233154,223531,c,902
903,218629,1740,7011,0,3685,231065,218629,a,903
904,1941,440,2125,0,220889,225395,220889,t,904
905,1820,211947,3537,0,5709,223013,211947,c,905
906,1744,456,5974,0,212502,220676,212502,t,906
907,1058,983,2012,0,215951,220004,215951,t,907
908,211330,2108,2507,0,4109,220054,211330,a,908
909,1847,208653,5697,0,4445,220642,208653,c,909
910,2533,617,5646,0,209263,218059,209263,t,910
911,1322,464,214232,0,1225,217243,214232,g,911
912,211031,1558,1983,0,2329,216901,211031,a,912
913,4995,206644,3202,0,2124,216965,206644,c,913
914,208911,1846,2355,0,2098,215210,208911,a,914
915,1165,427,211263,0,2145,215000,211263,g,915
916,3714,202102,3286,0,4806,213908,202102,c,916
917,1598,984,1856,0,208873,213311,208873,t,917
918,1087,828,208590,0,3400,213905,208590,g,918
919,1667,595,1105,0,209831,213198,209831,t,919
920,4212,205217,1768,0,2125,213322,205217,c,920
921,645,978,208977,0,2090,212690,208977,g,921
922,3132,201340,2776,0,4357,211605,201340,c,922
923,935,944,2217,0,205638,209734,205638,t,923
924,1658,202156,1040,0,6332,211186,202156,c,924
925,1665,201855,3439,0,5687,212646,201855,c,925
926,942,905,2476,0,207039,211362,207039,t,926
927,811,708,3137,0,206411,211067,206411,t,927
928,3990,201098,2684,0,3466,211238,201098,c,928
929,205310,1254,2107,0,1416,210087,205310,a,929
930,202886,1235,3080,0,4135,211336,202886,a,930
931,1389,955,3186,0,207685,213215,207685,t,931
932,664,484,210512,0,1425,213085,210512,g,932
933,206254,1357,2343,0,2580,212534,206254,a,933
934,6036,203310,2040,0,1388,212774,203310,c,934
935,208664,1033,966,0,1560,212223,208664,a,935
936,203874,1305,3823,0,3286,212288,203874,a,936
937,3691,680,1268,0,206785,212424,206785,t,937
938,869,565,209766,0,1604,212804,209766,g,938
939,1217,204945,2985,0,3979,213126,204945,c,939
940,987,316,208590,0,3390,213283,208590,g,940
941,670,410,1316,0,208051,210447,208051,t,941
942,1685,2545,1001,0,204974,210205,204974,t,942
943,1493,461,204790,0,2665,209409,204790,g,943
944,2776,198786,2204,0,3993,207759,198786,c,944
945,199099,1592,3005,0,3171,206867,199099,a,945
946,583,428,1759,0,203188,205958,203188,t,946
947,199258,2886,1637,0,4511,208292,199258,a,947
948,618,890,207861,0,992,210361,207861,g,948
949,1195,487,206479,0,934,209095,206479,g,949
950,201643,1339,2854,0,1862,207698,201643,a,950
951,199621,1247,1726,0,2780,205374,199621,a,951
952,1796,352,2892,0,200721,205761,200721,t,952
953,200353,1316,1277,0,3166,206112,200353,a,953
954,480,390,1989,0,205603,208462,205603,t,954
955,5520,201896,1671,0,1325,210412,201896,c,955
956,203428,1151,4292,0,1144,210015,203428,a,956
957,201637,1206,1899,0,3270,208012,201637,a,957
958,200848,1487,3021,0,2957,208313,200848,a,958
959,690,363,1472,0,205858,208383,205858,t,959
960,196213,1368,1683,0,3613,202877,196213,a,960
961,691,749,201860,0,1526,204826,201860,g,961
962,198100,2037,2491,0,1696,204324,198100,a,962
963,1249,297,200354,0,1737,203637,200354,g,963
964,189059,2432,1462,0,5705,198658,189059,a,964
965,1561,184143,4841,0,9059,199604,184143,c,965
966,3026,824,3296,0,192486,199632,192486,t,966
967,547,1240,3175,0,195557,200519,195557,t,967
968,467,2555,2002,0,196436,201460,196436,t,968
969,558,663,197303,0,2928,201452,197303,g,969
970,1449,994,3308,0,194019,199770,194019,t,970
971,192529,1661,2436,0,3020,199646,192529,a,971
972,1834,460,195354,0,2100,199748,195354,g,972
973,190384,1429,2441,0,3377,197631,190384,a,973
974,188938,1963,3375,0,4936,199212,188938,a,974
975,1948,1464,193986,0,2501,199899,193986,g,975
976,3013,2154,190819,0,2361,198347,190819,g,976
977,1709,1105,192533,0,3738,199085,192533,g,977
978,2011,1074,190145,0,6775,200005,190145,g,978
979,1714,1250,2807,0,194664,200435,194664,t,979
980,1014,1241,3145,0,194818,200218,194818,t,980
981,1091,1272,1537,0,199073,202973,199073,t,981
982,4073,194595,2525,0,3614,204807,194595,c,982
983,196258,2102,3365,0,4378,206103,196258,a,983
984,1450,532,202847,0,2143,206972,202847,g,984
985,1368,508,200988,0,1956,204820,200988,g,985
986,193206,2585,2951,0,4703,203445,193206,a,986
987,1504,364,200674,0,1732,204274,200674,g,987
988,1515,412,198166,0,3119,203212,198166,g,988
989,196589,1188,2162,0,3688,203627,196589,a,989
990,197119,1875,2247,0,4878,206119,197119,a,990
991,1230,454,203215,0,3237,208136,203215,g,991
992,2436,197145,2442,0,5774,207797,197145,c,992
993,1144,2050,4048,0,199448,206690,199448,t,993
994,552,1651,202431,0,2350,206984,202431,g,994
995,1187,371,198577,0,4274,204409,198577,g,995
996,2587,955,188869,0,5832,198243,188869,g,996
997,2847,893,1323,0,189640,194703,189640,t,997
998,2631,2416,1994,0,187291,194332,187291,t,998
999,1913,1055,188046,0,2091,193105,188046,g,999
1000,186636,1103,3238,0,2141,193118,186636,a,1000
1001,4350,184135,2899,0,1790,193174,184135,c,1001
1002,186757,886,2426,0,2275,192344,186757,a,1002
1003,1664,283,3737,0,186121,191805,186121,t,1003
1004,184842,2108,2056,0,3076,192082,184842,a,1004
1005,1246,1071,186394,0,4010,192721,186394,g,1005
1006,1099,805,998,0,193677,196579,193677,t,1006
1007,995,191657,2440,0,5785,200877,191657,c,1007
1008,344,189,2945,0,197865,201343,197865,t,1008
1009,1932,428,778,0,201299,204437,201299,t,1009
1010,201326,2720,1441,0,1564,207051,201326,a,1010
1011,2696,608,201976,0,1010,206290,201976,g,1011
1012,199640,929,1439,0,2455,204463,199640,a,1012
1013,198164,903,3107,0,2631,204805,198164,a,1013
1014,2588,197776,1741,0,3308,205413,197776,c,1014
1015,200000,1019,920,0,3840,205779,200000,a,1015
1016,281,1177,5592,0,202245,209295,202245,t,1016
1017,337,532,209021,0,1767,211657,209021,g,1017
1018,1525,174,208608,0,1615,211922,208608,g,1018
1019,207014,1333,1135,0,2335,211817,207014,a,1019
1020,207766,1326,1925,0,1470,212487,207766,a,1020
1021,1931,608,208204,0,1419,212162,208204,g,1021
1022,2316,201777,2644,0,5045,211782,201777,c,1022
1023,1796,1110,1793,0,207566,212265,207566,t,1023
1024,389,816,208772,0,2431,212408,208772,g,1024
1025,902,566,1513,0,210612,213593,210612,t,1025
1026,433,791,211268,0,2250,214742,211268,g,1026
1027,915,556,2492,0,211137,215100,211137,t,1027
1028,1166,399,211759,0,1528,214852,211759,g,1028
1029,208288,2073,1227,0,5027,216615,208288,a,1029
1030,1818,212626,1920,0,3726,220090,212626,c,1030
1031,915,1092,215833,0,1468,219308,215833,g,1031
1032,210366,1709,1110,0,5175,218360,210366,a,1032
1033,2306,212392,2893,0,1524,219115,212392,c,1033
1034,1291,323,208917,0,1201,211732,208917,g,1034
1035,205644,1130,1613,0,2486,210873,205644,a,1035
1036,863,701,4523,0,205413,211500,205413,t,1036
1037,975,4426,202483,0,2410,210294,202483,g,1037
1038,3079,1182,204399,0,5647,214307,204399,g,1038
1039,38703,170627,4950,0,2794,217074,170627,c,1039
1040,213465,878,1452,0,1139,216934,213465,a,1040
1041,213088,904,1774,0,1294,217060,213088,a,1041
1042,210932,1013,4059,0,3311,219315,210932,a,1042
1043,216809,1031,1605,0,1703,221148,216809,a,1043
1044,215399,1175,2824,0,1868,221266,215399,a,1044
1045,214881,2050,2517,0,1559,221007,214881,a,1045
1046,4461,210801,3033,0,2372,220667,210801,c,1046
1047,206828,628,1793,0,1597,210846,206828,a,1047
1048,202041,929,5586,0,1543,210099,202041,a,1048
1049,197421,7573,3435,0,4824,213253,197421,a,1049
1050,1432,206044,3257,0,7057,217790,206044,c,1050
1051,5982,207253,2102,0,1205,216542,207253,c,1051
1052,211215,643,3207,0,1261,216326,211215,a,1052
1053,211248,1103,2854,0,1540,216745,211248,a,1053
1054,3078,206637,5068,0,2013,216796,206637,c,1054
1055,205855,918,1361,0,3273,211407,205855,a,1055
1056,316,343,4856,0,207221,212736,207221,t,1056
1057,2067,3100,10598,0,198463,214228,198463,t,1057
1058,518,542,212925,0,779,214764,212925,g,1058
1059,2100,1387,208236,0,3871,215594,208236,g,1059
1060,206391,1153,2902,0,5693,216139,206391,a,1060
1061,691,311,1369,0,214524,216895,214524,t,1061
1062,1124,3998,1165,0,210820,217107,210820,t,1062
1063,521,303,3432,0,213004,217260,213004,t,1063
1064,1214,2154,2934,0,211264,217566,211264,t,1064
1065,4818,403,211383,0,806,217410,211383,g,1065
1066,210091,845,2653,0,2888,216477,210091,a,1066
1067,210552,1693,1752,0,1969,215966,210552,a,1067
1068,1401,208204,3678,0,2140,215423,208204,c,1068
1069,1372,177,5373,0,207054,213976,207054,t,1069
1070,5163,298,206816,0,1513,213790,206816,g,1070
1071,209422,951,944,0,2295,213612,209422,a,1071
1072,20943,450,885,0,191992,214270,191992,t,1072
1073,210518,1085,1041,0,1783,214427,210518,a,1073
1074,210340,843,2115,0,1468,214766,210340,a,1074
1075,210883,852,1311,0,1698,214744,210883,a,1075
1076,210461,1176,1317,0,2205,215159,210461,a,1076
1077,208545,1732,860,0,5546,216683,208545,a,1077
1078,1977,215399,796,0,2021,220193,215399,c,1078
1079,214717,954,752,0,997,217420,214717,a,1079
1080,3918,277,212485,0,1131,217811,212485,g,1080
1081,215077,737,517,0,2507,218838,215077,a,1081
1082,215926,974,1956,0,4585,223441,215926,a,1082
1083,908,3419,219929,0,1596,225852,219929,g,1083
1084,1267,222992,738,0,1708,226705,222992,c,1084
1085,11328,214385,1258,0,3488,230459,214385,c,1085
1086,230460,410,908,0,716,232494,230460,a,1086
1087,231277,541,355,0,633,232806,231277,a,1087
1088,230200,1897,265,0,1230,233592,230200,a,1088
1089,2216,231698,1075,0,388,235377,231698,c,1089
1090,232454,387,420,0,272,233533,232454,a,1090
1091,195848,35420,1572,0,1236,234076,195848,a,1091
1092,1556,231782,188,0,2168,235694,231782,c,1092
1093,1464,232558,1261,0,2363,237646,232558,c,1093
1094,1370,389,388,0,235991,238138,235991,t,1094
1095,829,369,236571,0,470,238239,236571,g,1095
1096,1497,233974,412,0,383,236266,233974,c,1096
1097,2111,230319,1415,0,321,234166,230319,c,1097
1098,229634,1035,732,0,4750,236151,229634,a,1098
1099,1576,234193,882,0,759,237410,234193,c,1099
1100,370,588,278,0,236394,237630,236394,t,1100
1101,878,234738,2002,0,693,238311,234738,c,1101
1102,351,127,1341,0,236699,238518,236699,t,1102
1103,236941,703,463,0,951,239058,236941,a,1103
1104,236258,1065,1625,0,1171,240119,236258,a,1104
1105,473,121,239332,0,1125,241051,239332,g,1105
1106,1137,147,238299,0,479,240062,238299,g,1106
1107,237707,923,920,0,300,239850,237707,a,1107
1108,237756,1776,282,0,1452,241266,237756,a,1108
1109,1808,248,239073,0,332,241461,239073,g,1109
1110,1951,494,1639,0,237287,241371,237287,t,1110
1111,239264,1455,509,0,1471,242699,239264,a,1111
1112,1095,239372,2427,0,987,243881,239372,c,1112
1113,397,286,589,0,242551,243823,242551,t,1113
1114,282,160,242699,0,3876,247017,242699,g,1114
1115,1313,474,331,0,247331,249449,247331,t,1115
1116,248527,543,525,0,813,250408,248527,a,1116
1117,1030,154,1723,0,247503,250410,247503,t,1117
1118,247426,736,702,0,560,249424,247426,a,1118
1119,1986,231,245809,0,1487,249513,245809,g,1119
1120,243363,1358,269,0,4752,249742,243363,a,1120
1121,673,225,249410,0,3025,253333,249410,g,1121
1122,992,364,250942,0,1205,253503,250942,g,1122
1123,2322,247771,1239,0,824,252156,247771,c,1123
1124,249780,1046,633,0,657,252116,249780,a,1124
1125,248392,648,1541,0,1803,252384,248392,a,1125
1126,251280,936,336,0,1103,253655,251280,a,1126
1127,1434,335,251294,0,1601,254664,251294,g,1127
1128,1559,251149,559,0,454,253721,251149,c,1128
1129,719,606,906,0,251937,254168,251937,t,1129
1130,636,333,252919,0,435,254323,252919,g,1130
1131,249886,755,492,0,1422,252555,249886,a,1131
1132,1950,248818,560,0,1335,252663,248818,c,1132
1133,2123,230600,3558,0,610,236891,230600,c,1133
1134,233801,582,1158,0,592,236133,233801,a,1134
1135,231691,835,1138,0,3920,237584,231691,a,1135
1136,1414,234506,1318,0,850,238088,234506,c,1136
1137,231801,1131,3188,0,8460,244580,231801,a,1137
1138,1263,240350,4211,0,1484,247308,240350,c,1138
1139,242858,1489,1184,0,396,245927,242858,a,1139
1140,241979,763,1929,0,2482,247153,241979,a,1140
1141,1681,241501,4188,0,6412,253782,241501,c,1141
1142,252365,1027,1089,0,1629,256110,252365,a,1142
1143,252979,778,2339,0,2987,259083,252979,a,1143
1144,3032,254407,2255,0,792,260486,254407,c,1144
1145,257630,947,1670,0,807,261054,257630,a,1145
1146,784,186,258972,0,2149,262091,258972,g,1146
1147,257980,2759,469,0,457,261665,257980,a,1147
1148,1599,196,3899,0,255158,260852,255158,t,1148
1149,422,490,431,0,260200,261543,260200,t,1149
1150,1591,258119,1977,0,320,262007,258119,c,1150
1151,870,617,1775,0,260131,263393,260131,t,1151
1152,2604,259616,202,0,1491,263913,259616,c,1152
1153,421,200,262529,0,382,263532,262529,g,1153
1154,2178,250849,1991,0,1575,256593,250849,c,1154
1155,2568,403,1497,0,248645,253113,248645,t,1155
1156,800,410,249973,0,957,252140,249973,g,1156
1157,2229,245654,2068,0,1240,251191,245654,c,1157
1158,2125,244787,2772,0,1052,250736,244787,c,1158
1159,2347,243113,2748,0,584,248792,243113,c,1159
1160,246353,743,999,0,274,248369,246353,a,1160
1161,245074,813,959,0,2323,249169,245074,a,1161
1162,2122,245000,2500,0,642,250264,245000,c,1162
1163,246875,1161,1231,0,1795,251062,246875,a,1163
1164,1728,246069,1820,0,1322,250939,246069,c,1164
1165,246070,1322,1783,0,1052,250227,246070,a,1165
1166,246256,1168,1422,0,10664,259510,246256,a,1166
1167,1336,562,262125,0,1195,265218,262125,g,1167
1168,1890,453,258365,0,1913,262621,258365,g,1168
1169,259821,989,837,0,662,262309,259821,a,1169
1170,1762,304,259633,0,379,262078,259633,g,1170
1171,258718,1180,807,0,710,261415,258718,a,1171
1172,255919,907,2125,0,3501,262452,255919,a,1172
1173,2098,258115,950,0,1775,262938,258115,c,1173
1174,3749,253322,2091,0,1319,260481,253322,c,1174
1175,1761,253109,3206,0,1582,259658,253109,c,1175
1176,254938,2529,976,0,2664,261107,254938,a,1176
1177,1397,460,258385,0,8283,268525,258385,g,1177
1178,1813,257167,707,0,4131,263818,257167,c,1178
1179,3522,253847,4361,0,522,262252,253847,c,1179
1180,1170,348,4291,0,256337,262146,256337,t,1180
1181,260523,810,831,0,1033,263197,260523,a,1181
1182,256322,1623,2172,0,2745,262862,256322,a,1182
1183,256496,3209,2617,0,1212,263534,256496,a,1183
1184,1271,855,3275,0,258248,263649,258248,t,1184
1185,1445,449,258578,0,428,260900,258578,g,1185
1186,256317,1128,443,0,2228,260116,256317,a,1186
1187,257579,1583,392,0,543,260097,257579,a,1187
1188,2234,513,256661,0,1383,260791,256661,g,1188
1189,253158,1130,699,0,2418,257405,253158,a,1189
1190,1264,430,254492,0,2491,258677,254492,g,1190
1191,2189,252353,427,0,2055,257024,252353,c,1191
1192,252881,1385,1696,0,1879,257841,252881,a,1192
1193,1238,969,252729,0,2719,257655,252729,g,1193
1194,1369,2102,246795,0,941,251207,246795,g,1194
1195,241694,1183,5981,0,3377,252235,241694,a,1195
1196,4893,241509,4889,0,4132,255423,241509,c,1196
1197,251991,1425,1028,0,2929,257373,251991,a,1197
1198,254870,1452,1480,0,2099,259901,254870,a,1198
1199,249171,1944,8877,0,825,260817,249171,a,1199
1200,257342,2109,894,0,2534,262879,257342,a,1200
1201,1000,560,261600,0,1421,264581,261600,g,1201
1202,1280,5691,255163,0,1926,264060,255163,g,1202
1203,3624,1462,7743,0,250788,263617,250788,t,1203
1204,1864,434,936,0,260318,263552,260318,t,1204
1205,2648,258864,1203,0,1168,263883,258864,c,1205
1206,1326,361,261669,0,334,263690,261669,g,1206
1207,1654,615,830,0,261235,264334,261235,t,1207
1208,1691,257769,5376,0,1890,266726,257769,c,1208
1209,746,448,1990,0,264094,267278,264094,t,1209
1210,846,726,264557,0,1955,268084,264557,g,1210
1211,1675,259806,5804,0,1790,269075,259806,c,1211
1212,266627,817,1242,0,480,269166,266627,a,1212
1213,266017,1043,1191,0,420,268671,266017,a,1213
1214,265499,1394,886,0,627,268406,265499,a,1214
1215,1872,260827,4972,0,512,268183,260827,c,1215
1216,265039,1391,629,0,1392,268451,265039,a,1216
1217,1209,262732,3776,0,347,268064,262732,c,1217
1218,1217,991,929,0,265449,268586,265449,t,1218
1219,1929,263467,2147,0,1359,268902,263467,c,1219
1220,1456,262969,2559,0,1679,268663,262969,c,1220
1221,261016,1479,2149,0,1232,265876,261016,a,1221
1222,851,1282,1588,0,262486,266207,262486,t,1222
1223,1393,1071,262169,0,1085,265718,262169,g,1223
1224,1827,360,261877,0,1531,265595,261877,g,1224
1225,2900,2147,1354,0,260005,266406,260005,t,1225
1226,694,2048,263515,0,1167,267424,263515,g,1226
1227,628,345,265426,0,738,267137,265426,g,1227
1228,260255,2077,1368,0,4130,267830,260255,a,1228
1229,3590,264053,839,0,1396,269878,264053,c,1229
1230,265349,1302,1401,0,506,268558,265349,a,1230
1231,487,608,266006,0,1498,268599,266006,g,1231
1232,264571,2636,316,0,2023,269546,264571,a,1232
1233,720,545,268029,0,722,270016,268029,g,1233
1234,522,986,266151,0,1122,268781,266151,g,1234
1235,257065,1938,1691,0,1086,261780,257065,a,1235
1236,1247,1277,1177,0,260469,264170,260469,t,1236
1237,3332,2512,256483,0,8006,270333,256483,g,1237
1238,902,642,271136,0,1912,274592,271136,g,1238
1239,1316,672,266973,0,2288,271249,266973,g,1239
1240,2808,312,263083,0,1362,267565,263083,g,1240
1241,262267,1456,2249,0,1790,267762,262267,a,1241
1242,264459,1480,1732,0,966,268637,264459,a,1242
1243,263157,1679,1056,0,3628,269520,263157,a,1243
1244,1228,2182,2880,0,263550,269840,263550,t,1244
1245,2071,1434,264607,0,822,268934,264607,g,1245
1246,1261,532,265142,0,701,267636,265142,g,1246
1247,261795,2074,1584,0,2030,267483,261795,a,1247
1248,3238,1509,803,0,267799,273349,267799,t,1248
1249,933,1209,269875,0,1280,273297,269875,g,1249
1250,3816,2268,1586,0,266467,274137,266467,t,1250
1251,2033,893,271334,0,1875,276135,271334,g,1251
1252,622,2182,271103,0,2229,276136,271103,g,1252
1253,268554,2332,3803,0,884,275573,268554,a,1253
1254,2876,767,2273,0,266645,272561,266645,t,1254
1255,1081,2306,2764,0,267710,273861,267710,t,1255
1256,267497,1711,4627,0,806,274641,267497,a,1256
1257,981,562,2307,0,269916,273766,269916,t,1257
1258,2389,842,2600,0,270481,276312,270481,t,1258
1259,1336,1647,2783,0,276621,282387,276621,t,1259
1260,1119,427,279817,0,1310,282673,279817,g,1260
1261,832,331,278140,0,1372,280675,278140,g,1261
1262,272775,1742,3001,0,1339,278857,272775,a,1262
1263,274024,1800,1594,0,1203,278621,274024,a,1263
1264,273468,1554,2002,0,1133,278157,273468,a,1264
1265,271520,1964,2746,0,1329,277559,271520,a,1265
1266,2268,859,273618,0,1145,277890,273618,g,1266
1267,2104,561,263530,0,2442,268637,263530,g,1267
1268,260908,1911,1586,0,6063,270468,260908,a,1268
1269,2647,1029,265460,0,1987,271123,265460,g,1269
1270,2602,372,265094,0,1531,269599,265094,g,1270
1271,4764,258469,2884,0,3818,269935,258469,c,1271
1272,264343,1373,2991,0,1568,270275,264343,a,1272
1273,1430,573,4670,0,264952,271625,264952,t,1273
1274,4232,2762,967,0,265220,273181,265220,t,1274
1275,458,704,271516,0,594,273272,271516,g,1275
1276,1573,3019,1885,0,266673,273150,266673,t,1276
1277,591,466,271166,0,689,272912,271166,g,1277
1278,265277,894,1143,0,4911,272225,265277,a,1278
1279,2595,266901,924,0,3198,273618,266901,c,1279
1280,2167,264341,3880,0,603,270991,264341,c,1280
1281,1570,301,1780,0,267435,271086,267435,t,1281
1282,719,690,269261,0,537,271207,269261,g,1282
1283,1484,487,956,0,267947,270874,267947,t,1283
1284,857,600,269009,0,998,271464,269009,g,1284
1285,2003,264209,2480,0,1204,269896,264209,c,1285
1286,1482,248,1975,0,265053,268758,265053,t,1286
1287,266290,1002,681,0,3233,271206,266290,a,1287
1288,1531,337,1023,0,271716,274607,271716,t,1288
1289,307,342,274084,0,2509,277242,274084,g,1289
1290,1366,319,743,0,275730,278158,275730,t,1290
1291,659,211,1402,0,277674,279946,277674,t,1291
1292,1507,277597,679,0,720,280503,277597,c,1292
1293,277309,1104,725,0,1391,280529,277309,a,1293
1294,980,277924,793,0,632,280329,277924,c,1294
1295,277662,757,1109,0,880,280408,277662,a,1295
1296,250,280,577,0,280106,281213,280106,t,1296
1297,297,309,280444,0,1890,282940,280444,g,1297
1298,1273,280564,659,0,1413,283909,280564,c,1298
1299,281224,869,453,0,741,283287,281224,a,1299
1300,281368,1073,815,0,911,284167,281368,a,1300
1301,282179,1257,671,0,520,284627,282179,a,1301
1302,282607,1181,442,0,1635,285865,282607,a,1302
1303,284510,1048,408,0,727,286693,284510,a,1303
1304,690,312,285306,0,322,286630,285306,g,1304
1305,283500,784,430,0,445,285159,283500,a,1305
1306,282734,648,692,0,3228,287302,282734,a,1306
1307,1561,285658,501,0,1241,288961,285658,c,1307
1308,283354,923,876,0,2701,287854,283354,a,1308
1309,419,382,476,0,287283,288560,287283,t,1309
1310,527,296,288360,0,689,289872,288360,g,1310
1311,287186,1061,598,0,1710,290555,287186,a,1311
1312,286116,1554,676,0,3384,291730,286116,a,1312
1313,286744,2711,1443,0,19030,309928,286744,a,1313
1314,455,209,315449,0,4802,320915,315449,g,1314
1315,685,187,315754,0,1461,318087,315754,g,1315
1316,314546,1441,1130,0,824,317941,314546,a,1316
1317,315179,1171,1074,0,1119,318543,315179,a,1317
1318,313706,1504,3483,0,1310,320003,313706,a,1318
1319,314960,1647,2281,0,2442,321330,314960,a,1319
1320,1030,352,318707,0,1526,321615,318707,g,1320
1321,1851,1145,1522,0,315970,320488,315970,t,1321
1322,1358,314412,2780,0,3960,322510,314412,c,1322
1323,363,194,320650,0,2071,323278,320650,g,1323
1324,1472,597,1742,0,318198,322009,318198,t,1324
1325,1132,432,315895,0,1642,319101,315895,g,1325
1326,5511,295440,2648,0,4049,307648,295440,c,1326
1327,297164,768,5035,0,2200,305167,297164,a,1327
1328,297825,1184,2179,0,3533,304721,297825,a,1328
1329,2373,292768,2201,0,10174,307516,292768,c,1329
1330,2556,298802,4051,0,4154,309563,298802,c,1330
1331,298497,1091,8283,0,5690,313561,298497,a,1331
1332,2082,251,312666,0,1635,316634,312666,g,1332
1333,310944,1866,2322,0,1348,316480,310944,a,1333
1334,308576,1455,4813,0,1498,316342,308576,a,1334
1335,307493,1705,4614,0,2751,316563,307493,a,1335
1336,305583,1463,5404,0,5980,318430,305583,a,1336
1337,2886,308761,2407,0,5777,319831,308761,c,1337
1338,674,480,6047,0,308690,315891,308690,t,1338
1339,656,1823,1371,0,312904,316754,312904,t,1339
1340,880,2252,312720,0,1125,316977,312720,g,1340
1341,2349,325,305760,0,2516,310950,305760,g,1341
1342,299323,1258,3263,0,3833,307677,299323,a,1342
1343,296966,1042,4144,0,4636,306788,296966,a,1343
1344,1010,369,2686,0,301798,305863,301798,t,1344
1345,298696,1054,1782,0,6042,307574,298696,a,1345
1346,3643,298954,4591,0,1444,308632,298954,c,1346
1347,301324,2399,2707,0,1739,308169,301324,a,1347
1348,3510,296356,4773,0,3259,307898,296356,c,1348
1349,4489,292144,3899,0,3338,303870,292144,c,1349
1350,291033,1820,4679,0,6233,303765,291033,a,1350
1351,1495,914,3527,0,298645,304581,298645,t,1351
1352,1180,2075,1496,0,301490,306241,301490,t,1352
1353,535,1127,301496,0,5546,308704,301496,g,1353
1354,2439,628,2212,0,303383,308662,303383,t,1354
1355,1394,459,305197,0,3358,310408,305197,g,1355
1356,302965,1251,1951,0,5870,312037,302965,a,1356
1357,2014,347,2108,0,308324,312793,308324,t,1357
1358,306118,2560,869,0,2398,311945,306118,a,1358
1359,303573,1295,2882,0,4070,311820,303573,a,1359
1360,3449,302781,3786,0,1676,311692,302781,c,1360
1361,301587,3905,3272,0,8687,317451,301587,a,1361
1362,1891,312920,2119,0,4548,321478,312920,c,1362
1363,2688,312709,3114,0,3350,321861,312709,c,1363
1364,1022,1101,1654,0,317337,321114,317337,t,1364
1365,2595,315752,889,0,1414,320650,315752,c,1365
1366,311820,2814,3323,0,3105,321062,311820,a,1366
1367,1592,311195,1564,0,4081,318432,311195,c,1367
1368,2705,544,2665,0,308138,314052,308138,t,1368
1369,2256,306486,2294,0,3190,314226,306486,c,1369
1370,308758,2151,1563,0,2231,314703,308758,a,1370
1371,849,457,310648,0,4158,316112,310648,g,1371
1372,1066,2599,310868,0,2123,316656,310868,g,1372
1373,1397,635,307396,0,1588,311016,307396,g,1373
1374,3899,518,302397,0,805,307619,302397,g,1374
1375,303693,1574,597,0,3182,309046,303693,a,1375
1376,306557,1508,784,0,2126,310975,306557,a,1376
1377,2033,810,306492,0,3243,312578,306492,g,1377
1378,306106,1318,1518,0,2678,311620,306106,a,1378
1379,580,375,309886,0,1285,312126,309886,g,1379
1380,2810,305095,891,0,2454,311250,305095,c,1380
1381,302565,873,5456,0,2803,311697,302565,a,1381
1382,886,514,1112,0,309014,311526,309014,t,1382
1383,1413,3695,304466,0,1112,310686,304466,g,1383
1384,3590,298962,5231,0,1393,309176,298962,c,1384
1385,298396,1104,1947,0,5849,307296,298396,a,1385
1386,1164,658,303894,0,1618,307334,303894,g,1386
1387,1563,1005,1022,0,303497,307087,303497,t,1387
1388,4478,299128,2351,0,1376,307333,299128,c,1388
1389,490,259,305192,0,736,306677,305192,g,1389
1390,3254,242,300279,0,1064,304839,300279,g,1390
1391,296200,1318,4000,0,1640,303158,296200,a,1391
1392,298079,1490,1695,0,1327,302591,298079,a,1392
1393,295251,1407,3391,0,2496,302545,295251,a,1393
1394,4252,468,1370,0,296298,302388,296298,t,1394
1395,1083,902,296417,0,927,299329,296417,g,1395
1396,291439,2622,1660,0,1654,297375,291439,a,1396
1397,4156,285488,4983,0,1621,296248,285488,c,1397
1398,277114,1367,1332,0,4702,284515,277114,a,1398
1399,3859,271056,5737,0,3435,284087,271056,c,1399
1400,275741,2321,1709,0,8789,288560,275741,a,1400
1401,1554,422,287963,0,2069,292008,287963,g,1401
1402,4101,582,285895,0,1298,291876,285895,g,1402
1403,285072,1614,2376,0,1796,290858,285072,a,1403
1404,285730,1321,1858,0,1985,290894,285730,a,1404
1405,284108,1629,3019,0,1623,290379,284108,a,1405
1406,282635,1295,3478,0,2419,289827,282635,a,1406
1407,2453,282093,2701,0,2148,289395,282093,c,1407
1408,272316,1408,4958,0,2863,281545,272316,a,1408
1409,744,821,3390,0,276080,281035,276080,t,1409
1410,1374,3423,271635,0,3085,279517,271635,g,1410
1411,1041,572,274121,0,2488,278222,274121,g,1411
1412,7220,259554,3782,0,5168,275724,259554,c,1412
1413,262502,1896,1663,0,7278,273339,262502,a,1413
1414,265704,3424,4332,0,4917,278377,265704,a,1414
1415,884,538,276836,0,859,279117,276836,g,1415
1416,4975,580,270053,0,1186,276794,270053,g,1416
1417,263996,1651,3318,0,2156,271121,263996,a,1417
1418,262333,2049,4723,0,2208,271313,262333,a,1418
1419,263922,1677,2880,0,2365,270844,263922,a,1419
1420,2022,645,2892,0,266464,272023,266464,t,1420
1421,7451,259371,4704,0,1118,272644,259371,c,1421
1422,260615,862,6787,0,3738,272002,260615,a,1422
1423,262109,1223,5799,0,2464,271595,262109,a,1423
1424,263170,2207,3943,0,2331,271651,263170,a,1424
1425,263708,1695,3159,0,2196,270758,263708,a,1425
1426,2193,285,5603,0,258680,266761,258680,t,1426
1427,254373,2538,1677,0,1716,260304,254373,a,1427
1428,248524,1912,5803,0,4016,260255,248524,a,1428
1429,3999,250924,3109,0,1196,259228,250924,c,1429
1430,239259,6988,5699,0,3333,255279,239259,a,1430
1431,1447,244856,4239,0,6518,257060,244856,c,1431
1432,3617,248835,3567,0,1670,257689,248835,c,1432
1433,248584,1804,4095,0,6063,260546,248584,a,1433
1434,7308,251337,1821,0,2222,262688,251337,c,1434
1435,256516,1475,3368,0,1247,262606,256516,a,1435
1436,1154,552,259526,0,1356,262588,259526,g,1436
1437,253028,2363,2174,0,4540,262105,253028,a,1437
1438,962,448,254612,0,5373,261395,254612,g,1438
1439,1872,1748,2485,0,253558,259663,253558,t,1439
1440,1227,2886,2289,0,254303,260705,254303,t,1440
1441,3933,253277,1617,0,3965,262792,253277,c,1441
1442,2511,253761,4612,0,2489,263373,253761,c,1442
1443,253981,1131,2518,0,3793,261423,253981,a,1443
1444,1660,1049,2296,0,254095,259100,254095,t,1444
1445,3207,249510,2348,0,3033,258098,249510,c,1445
1446,249863,1501,1843,0,6775,259982,249863,a,1446
1447,3558,252646,3941,0,1863,262008,252646,c,1447
1448,251498,1491,6954,0,1068,261011,251498,a,1448
1449,2228,356,256520,0,1271,260375,256520,g,1449
1450,246292,1636,2628,0,2576,253132,246292,a,1450
1451,246144,1375,4108,0,2414,254041,246144,a,1451
1452,3207,554,249085,0,1775,254621,249085,g,1452
1453,4090,239849,4578,0,2134,250651,239849,c,1453
1454,244673,1670,3894,0,1474,251711,244673,a,1454
1455,1108,444,247425,0,1392,250369,247425,g,1455
1456,236327,3596,4518,0,4138,248579,236327,a,1456
1457,1287,813,240399,0,5246,247745,240399,g,1457
1458,2835,1317,1610,0,238700,244462,238700,t,1458
1459,2930,2504,4668,0,235341,245443,235341,t,1459
1460,1674,584,239781,0,2704,244743,239781,g,1460
1461,235984,1529,2345,0,4299,244157,235984,a,1461
1462,4256,233272,4219,0,3316,245063,233272,c,1462
1463,227848,2033,5618,0,2738,238237,227848,a,1463
1464,1701,697,233837,0,1931,238166,233837,g,1464
1465,2851,931,228166,0,4214,236162,228166,g,1465
1466,3769,215756,5464,0,10308,235297,215756,c,1466
1467,4517,1091,2818,0,227005,235431,227005,t,1467
1468,225358,1327,2239,0,7252,236176,225358,a,1468
1469,1892,977,8551,0,226249,237669,226249,t,1469
1470,3546,1831,231280,0,2169,238826,231280,g,1470
1471,1547,782,234527,0,1945,238801,234527,g,1471
1472,4176,227160,3222,0,3315,237873,227160,c,1472
1473,225384,4940,2662,0,4683,237669,225384,a,1473
1474,2113,223670,5297,0,6575,237655,223670,c,1474
1475,1544,1017,2011,0,233855,238427,233855,t,1475
1476,1006,569,233400,0,3777,238752,233400,g,1476
1477,1310,992,899,0,235789,238990,235789,t,1477
1478,5286,229705,1583,0,2593,239167,229705,c,1478
1479,227901,2392,4688,0,4917,239898,227901,a,1479
1480,2322,229962,6151,0,1951,240386,229962,c,1480
1481,1042,461,236790,0,1659,239952,236790,g,1481
1482,229559,2400,2263,0,4360,238582,229559,a,1482
1483,3768,547,4850,0,229988,239153,229988,t,1483
1484,3461,1113,231863,0,2358,238795,231863,g,1484
1485,1514,1077,233995,0,2019,238605,233995,g,1485
1486,229419,1999,3828,0,4611,239857,229419,a,1486
1487,1702,741,234539,0,3633,240615,234539,g,1487
1488,2939,890,1929,0,233588,239346,233588,t,1488
1489,489,1113,234991,0,2304,238897,234991,g,1489
1490,3139,229163,1338,0,4752,238392,229163,c,1490
1491,1011,634,850,0,236174,238669,236174,t,1491
1492,1544,231937,1081,0,3908,238470,231937,c,1492
1493,1048,4434,1884,0,232191,239557,232191,t,1493
1494,1540,235506,1057,0,3223,241326,235506,c,1494
1495,2244,234421,4590,0,918,242173,234421,c,1495
1496,802,267,239320,0,1182,241571,239320,g,1496
1497,234104,1515,1927,0,3125,240671,234104,a,1497
1498,3239,466,234460,0,2163,240328,234460,g,1498
1499,230664,2192,2076,0,1898,236830,230664,a,1499
1500,228023,3174,2015,0,6448,239660,228023,a,1500
1501,2968,233527,3109,0,1342,240946,233527,c,1501
1502,2306,723,227627,0,1029,231685,227627,g,1502
1503,4513,1124,221429,0,1406,228472,221429,g,1503
1504,3675,1771,217612,0,2061,225119,217612,g,1504
1505,3124,214197,2448,0,7851,227620,214197,c,1505
1506,5135,208629,4812,0,4182,222758,208629,c,1506
1507,1192,1146,2428,0,217100,221866,217100,t,1507
1508,2700,214329,3220,0,1727,221976,214329,c,1508
1509,1126,512,218599,0,1309,221546,218599,g,1509
1510,208703,2990,3264,0,8576,223533,208703,a,1510
1511,2850,211930,4192,0,6445,225417,211930,c,1511
1512,1941,823,2757,0,218239,223760,218239,t,1512
1513,2035,684,2893,0,217443,223055,217443,t,1513
1514,7029,206347,3317,0,2549,219242,206347,c,1514
1515,212357,2008,2042,0,2038,218445,212357,a,1515
1516,209076,2270,3573,0,3363,218282,209076,a,1516
1517,2155,607,5643,0,209983,218388,209983,t,1517
1518,878,573,213829,0,2003,217283,213829,g,1518
1519,208526,2354,4321,0,2488,217689,208526,a,1519
1520,2435,614,213105,0,1819,217973,213105,g,1520
1521,207112,2396,2301,0,4695,216504,207112,a,1521
1522,1385,660,5859,0,208512,216416,208512,t,1522
1523,1792,1679,209058,0,1486,214015,209058,g,1523
1524,665,417,209554,0,3505,214141,209554,g,1524
1525,3293,1509,2461,0,207972,215235,207972,t,1525
1526,1772,627,207193,0,6073,215665,207193,g,1526
1527,1689,582,2516,0,208534,213321,208534,t,1527
1528,3819,917,2434,0,205878,213048,205878,t,1528
1529,954,851,208658,0,2622,213085,208658,g,1529
1530,2303,202109,2445,0,4686,211543,202109,c,1530
1531,981,1734,4130,0,203990,210835,203990,t,1531
1532,1104,1209,203474,0,1968,207755,203474,g,1532
1533,8065,191929,2790,0,2794,205578,191929,c,1533
1534,197311,1832,3414,0,1606,204163,197311,a,1534
1535,194397,1970,2701,0,3435,202503,194397,a,1535
1536,193930,2415,1643,0,4642,202630,193930,a,1536
1537,903,1023,6417,0,196321,204664,196321,t,1537
1538,1924,979,195645,0,1444,199992,195645,g,1538
1539,7787,428,190105,0,1128,199448,190105,g,1539
1540,190780,2155,2585,0,2222,197742,190780,a,1540
1541,188522,2067,2417,0,3032,196038,188522,a,1541
1542,186476,2313,3495,0,2544,194828,186476,a,1542
1543,185095,1619,4230,0,3692,194636,185095,a,1543
1544,3556,945,3677,0,186950,195128,186950,t,1544
1545,190259,1481,1395,0,1786,194921,190259,a,1545
1546,186382,1274,4625,0,2479,194760,186382,a,1546
1547,188047,2000,2856,0,3058,195961,188047,a,1547
1548,1024,1027,190914,0,5254,198219,190914,g,1548
1549,3403,186631,1408,0,5338,196780,186631,c,1549
1550,1166,604,4146,0,189252,195168,189252,t,1550
1551,844,2951,4933,0,186095,194823,186095,t,1551
1552,1019,1716,189552,0,1646,193933,189552,g,1552
1553,1376,656,185597,0,3398,191027,185597,g,1553
1554,3064,174461,2441,0,4963,184929,174461,c,1554
1555,2374,1173,6268,0,172014,181829,172014,t,1555
1556,1914,1759,175017,0,2053,180743,175017,g,1556
1557,1886,590,173286,0,3451,179213,173286,g,1557
1558,3374,1959,4924,0,168571,178828,168571,t,1558
1559,1285,1511,173628,0,2732,179156,173628,g,1559
1560,3671,165476,2451,0,3150,174748,165476,c,1560
1561,164360,3793,2809,0,2731,173693,164360,a,1561
1562,3942,163199,2298,0,3183,172622,163199,c,1562
1563,163036,3312,4982,0,2442,173772,163036,a,1563
1564,1060,609,172280,0,1829,175778,172280,g,1564
1565,1899,790,172200,0,1433,176322,172200,g,1565
1566,22038,149779,3245,0,1661,176723,149779,c,1566
1567,170720,3168,1193,0,1676,176757,170720,a,1567
1568,170032,1814,2299,0,2506,176651,170032,a,1568
1569,2937,525,5398,0,168347,177207,168347,t,1569
1570,1300,521,174999,0,1658,178478,174999,g,1570
1571,1439,1193,170893,0,5053,178578,170893,g,1571
1572,1810,970,3254,0,171937,177971,171937,t,1572
1573,559,1759,1148,0,178692,182158,178692,t,1573
1574,1466,181857,593,0,1715,185631,181857,c,1574
1575,1364,181259,2338,0,1732,186693,181259,c,1575
1576,1587,639,1144,0,182503,185873,182503,t,1576
1577,182454,1428,1264,0,531,185677,182454,a,1577
1578,2684,596,181008,0,919,185207,181008,g,1578
1579,171316,10923,910,0,2740,185889,171316,a,1579
1580,2423,181959,647,0,2367,187396,181959,c,1580
1581,1570,185021,514,0,319,187424,185021,c,1581
1582,730,656,871,0,185563,187820,185563,t,1582
1583,1058,1019,184264,0,1338,187679,184264,g,1583
1584,1907,184092,1022,0,1247,188268,184092,c,1584
1585,1683,185403,998,0,1447,189531,185403,c,1585
1586,732,598,186768,0,316,188414,186768,g,1586
1587,1383,642,1037,0,185184,188246,185184,t,1587
1588,656,850,712,0,187142,189360,187142,t,1588
1589,573,615,187370,0,1563,190121,187370,g,1589
1590,1649,186733,798,0,2954,192134,186733,c,1590
1591,1386,190683,509,0,585,193163,190683,c,1591
1592,189063,3288,495,0,606,193452,189063,a,1592
1593,1058,347,509,0,194597,196511,194597,t,1593
1594,824,570,195204,0,2485,199083,195204,g,1594
1595,556,399,198001,0,1338,200294,198001,g,1595
1596,1675,197790,725,0,378,200568,197790,c,1596
1597,930,1811,1039,0,196787,200567,196787,t,1597
1598,525,538,198394,0,1771,201228,198394,g,1598
1599,1622,198373,717,0,963,201675,198373,c,1599
1600,1318,199665,422,0,724,202129,199665,c,1600
1601,1056,197779,300,0,864,199999,197779,c,1601
1602,560,904,197974,0,427,199865,197974,g,1602
1603,447,416,197980,0,1511,200354,197980,g,1603
1604,195355,3256,1304,0,588,200503,195355,a,1604
1605,1322,719,197846,0,2361,202248,197846,g,1605
1606,2005,197914,694,0,1204,201817,197914,c,1606
1607,873,850,199385,0,436,201544,199385,g,1607
1608,1239,369,199232,0,433,201273,199232,g,1608
1609,194465,3275,1228,0,1384,200352,194465,a,1609
1610,3543,195067,1103,0,387,200100,195067,c,1610
1611,180622,5563,1444,0,1012,188641,180622,a,1611
1612,2698,178192,6995,0,1047,188932,178192,c,1612
1613,181945,4460,1151,0,4439,191995,181945,a,1613
1614,3749,178305,1846,0,4682,188582,178305,c,1614
1615,174976,8296,2640,0,744,186656,174976,a,1615
1616,177634,2506,4191,0,1223,185554,177634,a,1616
1617,3108,928,180915,0,552,185503,180915,g,1617
1618,4598,2052,164098,0,2226,172974,164098,g,1618
1619,167471,2506,2689,0,645,173311,167471,a,1619
1620,4195,1455,4856,0,162702,173208,162702,t,1620
1621,4620,165616,1499,0,917,172652,165616,c,1621
1622,159783,1763,10225,0,516,172287,159783,a,1622
1623,159320,4559,5865,0,3684,173428,159320,a,1623
1624,163795,2731,7106,0,407,174039,163795,a,1624
1625,2990,938,3967,0,166274,174169,166274,t,1625
1626,3595,9236,2074,0,157591,172496,157591,t,1626
1627,2255,1120,168207,0,917,172499,168207,g,1627
1628,931,1578,161049,0,7523,171081,161049,g,1628
1629,155287,2783,10755,0,952,169777,155287,a,1629
1630,3161,1061,3727,0,161470,169419,161470,t,1630
1631,162703,2794,1269,0,5152,171918,162703,a,1631
1632,2528,158500,10909,0,1076,173013,158500,c,1632
1633,158379,2364,11102,0,1631,173476,158379,a,1633
1634,1819,530,169679,0,967,172995,169679,g,1634
1635,165714,2122,3028,0,1331,172195,165714,a,1635
1636,166704,1628,1700,0,1254,171286,166704,a,1636
1637,167277,1521,1587,0,3052,173437,167277,a,1637
1638,2268,636,169786,0,1442,174132,169786,g,1638
1639,168039,2460,2197,0,1149,173845,168039,a,1639
1640,1432,520,170569,0,658,173179,170569,g,1640
1641,164835,1822,1925,0,3492,172074,164835,a,1641
1642,3030,161866,4942,0,2794,172632,161866,c,1642
1643,163533,3657,2844,0,1443,171477,163533,a,1643
1644,2251,638,1789,0,166423,171101,166423,t,1644
1645,2080,2350,1756,0,164250,170436,164250,t,1645
1646,766,618,167623,0,8565,177572,167623,g,1646
1647,995,405,178086,0,533,180019,178086,g,1647
1648,1100,561,2272,0,176041,179974,176041,t,1648
1649,2072,175462,1641,0,621,179796,175462,c,1649
1650,172713,2163,3282,0,1126,179284,172713,a,1650
1651,1753,175141,1011,0,665,178570,175141,c,1651
1652,621,2017,1512,0,173736,177886,173736,t,1652
1653,666,441,2036,0,174288,177431,174288,t,1653
1654,502,435,1148,0,177849,179934,177849,t,1654
1655,1291,178308,779,0,901,181279,178308,c,1655
1656,178170,1358,1135,0,1004,181667,178170,a,1656
1657,179596,872,744,0,837,182049,179596,a,1657
1658,180425,948,478,0,440,182291,180425,a,1658
1659,180101,728,756,0,252,181837,180101,a,1659
1660,180074,761,465,0,159,181459,180074,a,1660
1661,978,241,531,0,179756,181506,179756,t,1661
1662,1423,178511,341,0,640,180915,178511,c,1662
1663,1459,177771,701,0,593,180524,177771,c,1663
1664,2469,174624,321,0,592,178006,174624,c,1664
1665,1126,174501,1777,0,255,177659,174501,c,1665
1666,174265,1621,696,0,407,176989,174265,a,1666
1667,847,358,353,0,175404,176962,175404,t,1667
1668,559,1637,174086,0,1639,177921,174086,g,1668
1669,1104,174369,1667,0,1541,178681,174369,c,1669
1670,606,397,176997,0,466,178466,176997,g,1670
1671,172551,1317,544,0,595,175007,172551,a,1671
1672,172050,1607,876,0,418,174951,172050,a,1672
1673,1462,335,172842,0,746,175385,172842,g,1673
1674,170992,1049,1257,0,423,173721,170992,a,1674
1675,171011,732,1639,0,1206,174588,171011,a,1675
1676,172277,974,502,0,3666,177419,172277,a,1676
1677,2616,173321,1659,0,1601,179197,173321,c,1677
1678,173474,1732,915,0,3547,179668,173474,a,1678
1679,1098,367,178625,0,575,180665,178625,g,1679
1680,1539,887,175284,0,440,178150,175284,g,1680
1681,167555,1166,1315,0,879,170915,167555,a,1681
1682,2704,724,2779,0,165891,172098,165891,t,1682
1683,3451,1344,167105,0,439,172339,167105,g,1683
1684,1678,424,3218,0,167127,172447,167127,t,1684
1685,1211,4156,714,0,169417,175498,169417,t,1685
1686,537,298,175407,0,466,176708,175407,g,1686
1687,1136,325,1367,0,173181,176009,173181,t,1687
1688,1818,3587,362,0,171620,177387,171620,t,1688
1689,490,364,176517,0,738,178109,176517,g,1689
1690,1266,596,1123,0,174753,177738,174753,t,1690
1691,578,354,4346,0,172561,177839,172561,t,1691
1692,581,709,664,0,175829,177783,175829,t,1692
1693,3593,654,496,0,172857,177600,172857,t,1693
1694,522,638,173655,0,1771,176586,173655,g,1694
1695,1128,194,173153,0,582,175057,173153,g,1695
1696,475,234,173374,0,467,174550,173374,g,1696
1697,171651,842,443,0,409,173345,171651,a,1697
1698,2509,274,508,0,169301,172592,169301,t,1698
1699,2783,168578,836,0,398,172595,168578,c,1699
1700,1604,167314,2550,0,3543,175011,167314,c,1700
1701,2303,171047,1437,0,569,175356,171047,c,1701
1702,172447,1061,1479,0,982,175969,172447,a,1702
1703,173289,1209,479,0,4328,179305,173289,a,1703
1704,1265,341,179045,0,1298,181949,179045,g,1704
1705,178805,1213,341,0,1788,182147,178805,a,1705
1706,178644,1099,1151,0,814,181708,178644,a,1706
1707,972,859,179264,0,952,182047,179264,g,1707
1708,912,456,179952,0,794,182114,179952,g,1708
1709,705,616,179803,0,1744,182868,179803,g,1709
1710,513,461,181156,0,937,183067,181156,g,1710
1711,1134,179241,765,0,1673,182813,179241,c,1711
1712,1283,180408,540,0,727,182958,180408,c,1712
1713,180635,1151,805,0,1539,184130,180635,a,1713
1714,634,260,652,0,184076,185622,184076,t,1714
1715,357,323,185142,0,780,186602,185142,g,1715
1716,1327,184153,830,0,488,186798,184153,c,1716
1717,184780,1211,436,0,835,187262,184780,a,1717
1718,2011,184725,346,0,507,187589,184725,c,1718
1719,185462,1126,345,0,1626,188559,185462,a,1719
1720,1325,186823,816,0,832,189796,186823,c,1720
1721,188364,1126,150,0,332,189972,188364,a,1721
1722,746,247,188746,0,491,190230,188746,g,1722
1723,1479,187823,232,0,532,190066,187823,c,1723
1724,187014,1626,619,0,1104,190363,187014,a,1724
1725,1428,188548,303,0,346,190625,188548,c,1725
1726,467,416,368,0,188174,189425,188174,t,1726
1727,1145,187503,359,0,379,189386,187503,c,1727
1728,185678,1317,502,0,666,188163,185678,a,1728
1729,1293,184871,1121,0,429,187714,184871,c,1729
1730,180982,1138,903,0,543,183566,180982,a,1730
1731,2329,498,178687,0,908,182422,178687,g,1731
1732,1674,861,177096,0,926,180557,177096,g,1732
1733,4176,699,167385,0,911,173171,167385,g,1733
1734,2098,468,166724,0,1471,170761,166724,g,1734
1735,3255,159822,1763,0,2061,166901,159822,c,1735
1736,3011,157187,3538,0,1985,165721,157187,c,1736
1737,160983,1029,1598,0,20050,183660,160983,a,1737
1738,1841,185539,3518,0,1519,192417,185539,c,1738
1739,186534,1575,3974,0,541,192624,186534,a,1739
1740,697,220,191418,0,325,192660,191418,g,1740
1741,189314,1277,1362,0,582,192535,189314,a,1741
1742,188785,1437,1704,0,591,192517,188785,a,1742
1743,188707,1330,1908,0,587,192532,188707,a,1743
1744,1167,360,2447,0,188596,192570,188596,t,1744
1745,1949,185256,3138,0,1345,191688,185256,c,1745
1746,1871,184313,2643,0,2773,191600,184313,c,1746
1747,186625,1548,870,0,1586,190629,186625,a,1747
1748,750,589,187411,0,452,189202,187411,g,1748
1749,179451,1079,1166,0,1199,182895,179451,a,1749
1750,933,1580,2372,0,178272,183157,178272,t,1750
1751,1498,1923,178957,0,281,182659,178957,g,1751
1752,964,367,1524,0,179632,182487,179632,t,1752
1753,1928,178538,1190,0,499,182155,178538,c,1753
1754,175971,755,4746,0,237,181709,175971,a,1754
1755,1695,405,1937,0,179065,183102,179065,t,1755
1756,2530,176185,2135,0,4171,185021,176185,c,1756
1757,181138,1089,2620,0,2925,187772,181138,a,1757
1758,604,246,186478,0,2314,189642,186478,g,1758
1759,1089,439,187155,0,794,189477,187155,g,1759
1760,185104,1269,1775,0,656,188804,185104,a,1760
1761,186462,1070,886,0,742,189160,186462,a,1761
1762,185476,906,1666,0,2096,190144,185476,a,1762
1763,1411,186705,1181,0,812,190109,186705,c,1763
1764,1260,265,2381,0,185658,189564,185658,t,1764
1765,422,557,1123,0,187190,189292,187190,t,1765
1766,185827,1706,984,0,699,189216,185827,a,1766
1767,676,185076,2466,0,888,189106,185076,c,1767
1768,1077,311,504,0,188106,189998,188106,t,1768
1769,240,195,189342,0,430,190207,189342,g,1769
1770,1297,476,670,0,187015,189458,187015,t,1770
1771,1465,216,387,0,188001,190069,188001,t,1771
1772,1115,187645,1140,0,393,190293,187645,c,1772
1773,187555,708,885,0,1568,190716,187555,a,1773
1774,731,186183,1573,0,1566,190053,186183,c,1774
1775,185728,666,625,0,3909,190928,185728,a,1775
1776,392,135,190919,0,3231,194677,190919,g,1776
1777,647,241,193105,0,1450,195443,193105,g,1777
1778,193448,948,404,0,1506,196306,193448,a,1778
1779,715,194359,1168,0,1074,197316,194359,c,1779
1780,195622,929,594,0,1013,198158,195622,a,1780
1781,285,150,355,0,204781,205571,204781,t,1781
1782,777,206633,193,0,250,207853,206633,c,1782
1783,528,407,787,0,206443,208165,206443,t,1783
1784,812,206136,934,0,189,208071,206136,c,1784
1785,206119,571,476,0,442,207608,206119,a,1785
1786,206038,810,488,0,956,208292,206038,a,1786
1787,266,124,207867,0,455,208712,207867,g,1787
1788,1541,520,616,0,205445,208122,205445,t,1788
1789,411,169,206918,0,252,207750,206918,g,1789
1790,1030,206034,315,0,623,208002,206034,c,1790
1791,205606,674,389,0,294,206963,205606,a,1791
1792,434,246,205408,0,615,206703,205408,g,1792
1793,1006,383,195864,0,1812,199065,195864,g,1793
1794,1302,194582,873,0,1952,198709,194582,c,1794
1795,1192,1188,973,0,194581,197934,194581,t,1795
1796,356,192,196574,0,756,197878,196574,g,1796
1797,194716,1366,271,0,2464,198817,194716,a,1797
1798,906,188,197773,0,445,199312,197773,g,1798
1799,481,398,195452,0,1681,198012,195452,g,1799
1800,193354,843,594,0,590,195381,193354,a,1800
1801,713,870,2218,0,197110,200911,197110,t,1801
1802,770,570,199682,0,4364,205386,199682,g,1802
1803,669,170,204661,0,1902,207402,204661,g,1803
1804,202733,822,749,0,2607,206911,202733,a,1804
1805,3870,201510,1520,0,1127,208027,201510,c,1805
1806,199585,545,2110,0,487,202727,199585,a,1806
1807,197111,1043,3502,0,697,202353,197111,a,1807
1808,198234,1294,1834,0,1423,202785,198234,a,1808
1809,829,197341,4075,0,1175,203420,197341,c,1809
1810,2782,468,1698,0,195094,200042,195094,t,1810
1811,195567,461,2476,0,1781,200285,195567,a,1811
1812,955,193920,3901,0,1646,200422,193920,c,1812
1813,197275,712,1394,0,788,200169,197275,a,1813
1814,285,160,196527,0,3173,200145,196527,g,1814
1815,2277,195735,1169,0,422,199603,195735,c,1815
1816,567,315,1124,0,197809,199815,197809,t,1816
1817,1104,195547,2411,0,840,199902,195547,c,1817
1818,193182,780,3220,0,2574,199756,193182,a,1818
1819,195704,1351,1477,0,646,199178,195704,a,1819
1820,194440,1294,2344,0,2594,200672,194440,a,1820
1821,2466,311,198505,0,761,202043,198505,g,1821
1822,549,185,199458,0,606,200798,199458,g,1822
1823,197986,1042,624,0,915,200567,197986,a,1823
1824,196398,952,2754,0,631,200735,196398,a,1824
1825,1318,776,859,0,201865,204818,201865,t,1825
1826,798,471,205045,0,653,206967,205045,g,1826
1827,1036,388,1077,0,205143,207644,205143,t,1827
1828,2799,203802,898,0,3178,210677,203802,c,1828
1829,208103,714,2883,0,635,212335,208103,a,1829
1830,2572,178,836,0,209268,212854,209268,t,1830
1831,209269,840,820,0,2921,213850,209269,a,1831
1832,1518,210423,1084,0,639,213664,210423,c,1832
1833,456,283,683,0,211465,212887,211465,t,1833
1834,813,210264,1025,0,819,212921,210264,c,1834
1835,545,373,2423,0,209396,212737,209396,t,1835
1836,208983,1250,1219,0,602,212054,208983,a,1836
1837,818,576,1260,0,209402,212056,209402,t,1837
1838,326,311,209722,0,345,210704,209722,g,1838
1839,1165,364,1466,0,207399,210394,207399,t,1839
1840,605,208,208405,0,787,210005,208405,g,1840
1841,1295,206773,580,0,742,209390,206773,c,1841
1842,206546,582,900,0,907,208935,206546,a,1842
1843,900,204772,968,0,727,207367,204772,c,1843
1844,203158,1124,998,0,3187,208467,203158,a,1844
1845,249,178,209394,0,3983,213804,209394,g,1845
1846,1176,255,213738,0,729,215898,213738,g,1846
1847,211978,827,796,0,558,214159,211978,a,1847
1848,211519,1234,836,0,501,214090,211519,a,1848
1849,211699,1055,424,0,3648,216826,211699,a,1849
1850,251,120,218517,0,1064,219952,218517,g,1850
1851,1483,807,234,0,217583,220107,217583,t,1851
1852,439,183,1262,0,218579,220463,218579,t,1852
1853,195,267,543,0,219598,220603,219598,t,1853
1854,219369,784,394,0,396,220943,219369,a,1854
1855,217522,919,1459,0,346,220246,217522,a,1855
1856,218221,1383,178,0,1027,220809,218221,a,1856
1857,285,176,220233,0,385,221079,220233,g,1857
1858,984,510,362,0,219118,220974,219118,t,1858
1859,582,857,214,0,219901,221554,219901,t,1859
1860,201,354,220998,0,978,222531,220998,g,1860
1861,948,317,713,0,221305,223283,221305,t,1861
1862,243,208,222329,0,572,223352,222329,g,1862
1863,214818,851,373,0,1733,217775,214818,a,1863
1864,214946,1136,970,0,3188,220240,214946,a,1864
1865,688,1213,219025,0,1163,222089,219025,g,1865
1866,399,111,220533,0,835,221878,220533,g,1866
1867,218747,788,1777,0,548,221860,218747,a,1867
1868,220146,757,594,0,544,222041,220146,a,1868
1869,220008,661,491,0,454,221614,220008,a,1869
1870,401,179,2450,0,219262,222292,219262,t,1870
1871,219179,895,269,0,1216,221559,219179,a,1871
1872,389,189,220627,0,7214,228419,220627,g,1872
1873,1213,228670,449,0,1576,231908,228670,c,1873
1874,227016,613,2612,0,948,231189,227016,a,1874
1875,659,229,229127,0,1000,231015,229127,g,1875
1876,223832,714,791,0,755,226092,223832,a,1876
1877,222534,782,1282,0,564,225162,222534,a,1877
1878,221401,688,1474,0,1391,224954,221401,a,1878
1879,2057,220181,1149,0,913,224300,220181,c,1879
1880,220460,576,1977,0,1099,224112,220460,a,1880
1881,789,220932,2121,0,412,224254,220932,c,1881
1882,221249,544,1824,0,492,224109,221249,a,1882
1883,218933,558,946,0,2423,222860,218933,a,1883
1884,1171,219254,1421,0,1417,223263,219254,c,1884
1885,213022,815,1498,0,2077,217412,213022,a,1885
1886,213,1323,1826,0,215447,218809,215447,t,1886
1887,711,849,217304,0,2291,221155,217304,g,1887
1888,368,204,220062,0,1678,222312,220062,g,1888
1889,216077,983,1267,0,960,219287,216077,a,1889
1890,215070,731,1217,0,2051,219069,215070,a,1890
1891,2819,213193,2710,0,916,219638,213193,c,1891
1892,208318,488,2062,0,1027,211895,208318,a,1892
1893,207881,1089,2241,0,692,211903,207881,a,1893
1894,859,250,2264,0,209072,212445,209072,t,1894
1895,206031,3929,535,0,1444,211939,206031,a,1895
1896,543,455,207315,0,511,208824,207315,g,1896
1897,3812,579,2469,0,199452,206312,199452,t,1897
1898,1805,813,4347,0,201617,208582,201617,t,1898
1899,202535,1440,944,0,1440,206359,202535,a,1899
1900,2293,407,1000,0,202971,206671,202971,t,1900
1901,1992,200423,2347,0,2051,206813,200423,c,1901
1902,197359,734,3913,0,893,202899,197359,a,1902
1903,670,296,200718,0,541,202225,200718,g,1903
1904,194187,2322,738,0,5679,202926,194187,a,1904
1905,1310,325,201366,0,1891,204892,201366,g,1905
1906,3106,1836,2166,0,195752,202860,195752,t,1906
1907,194950,1616,4189,0,2155,202910,194950,a,1907
1908,1961,195429,4093,0,1283,202766,195429,c,1908
1909,196253,865,2768,0,1614,201500,196253,a,1909
1910,194883,893,2608,0,2670,201054,194883,a,1910
1911,1035,2423,2824,0,194946,201228,194946,t,1911
1912,193837,2008,2869,0,1571,200285,193837,a,1912
1913,447,631,2089,0,197605,200772,197605,t,1913
1914,478,476,197980,0,752,199686,197980,g,1914
1915,191093,886,1314,0,5750,199043,191093,a,1915
1916,194619,1187,632,0,6560,202998,194619,a,1916
1917,1499,687,200401,0,4055,206642,200401,g,1917
1918,3158,761,201797,0,7258,212974,201797,g,1918
1919,1421,674,210939,0,3591,216625,210939,g,1919
1920,4685,1196,209862,0,1318,217061,209862,g,1920
1921,211445,976,1256,0,5742,219419,211445,a,1921
1922,5293,212829,1817,0,1757,221696,212829,c,1922
1923,2926,651,213068,0,2638,219283,213068,g,1923
1924,3038,300,216090,0,481,219909,216090,g,1924
1925,4775,494,3083,0,211490,219842,211490,t,1925
1926,1083,1071,2175,0,223017,227346,223017,t,1926
1927,1425,225231,4226,0,1213,232095,225231,c,1927
1928,886,247,2435,0,228304,231872,228304,t,1928
1929,3410,224007,1667,0,2221,231305,224007,c,1929
1930,1684,223790,4333,0,1647,231454,223790,c,1930
1931,225220,932,3593,0,1193,230938,225220,a,1931
1932,487,659,1153,0,231730,234029,231730,t,1932
1933,613,1183,233677,0,398,235871,233677,g,1933
1934,769,340,2264,0,232090,235463,232090,t,1934
1935,232497,1075,491,0,729,234792,232497,a,1935
1936,231010,1173,1387,0,580,234150,231010,a,1936
1937,981,125,232444,0,508,234058,232444,g,1937
1938,228106,988,495,0,648,230237,228106,a,1938
1939,644,267,1064,0,228135,230110,228135,t,1939
1940,1312,227836,337,0,585,230070,227836,c,1940
1941,1655,226572,538,0,1511,230276,226572,c,1941
1942,1178,227339,978,0,1972,231467,227339,c,1942
1943,494,294,898,0,230379,232065,230379,t,1943
1944,331,317,1398,0,230079,232125,230079,t,1944
1945,304,141,397,0,231050,231892,231050,t,1945
1946,741,401,719,0,230330,232191,230330,t,1946
1947,331,136,230996,0,961,232424,230996,g,1947
1948,230068,1130,483,0,473,232154,230068,a,1948
1949,329,108,231305,0,363,232105,231305,g,1949
1950,227785,870,216,0,357,229228,227785,a,1950
1951,410,120,1966,0,226827,229323,226827,t,1951
1952,227714,864,119,0,571,229268,227714,a,1952
1953,225885,853,938,0,2284,229960,225885,a,1953
1954,353,1252,198,0,228963,230766,228963,t,1954
1955,748,782,228726,0,580,230836,228726,g,1955
1956,473,118,229424,0,1145,231160,229424,g,1956
1957,229081,1012,355,0,1237,231685,229081,a,1957
1958,688,287,1754,0,228847,231576,228847,t,1958
1959,396,362,453,0,230769,231980,230769,t,1959
1960,1673,497,293,0,233911,236374,233911,t,1960
1961,259,275,237645,0,1868,240047,237645,g,1961
1962,2371,181,237637,0,2351,242540,237637,g,1962
1963,239368,918,2087,0,1359,243732,239368,a,1963
1964,242313,986,433,0,2297,246029,242313,a,1964
1965,245031,907,716,0,578,247232,245031,a,1965
1966,245583,932,293,0,819,247627,245583,a,1966
1967,244471,1104,1970,0,288,247833,244471,a,1967
1968,246088,1322,192,0,1522,249124,246088,a,1968
1969,385,144,248615,0,599,249743,248615,g,1969
1970,241973,889,217,0,4017,247096,241973,a,1970
1971,910,244559,2827,0,461,248757,244559,c,1971
1972,246347,626,872,0,626,248471,246347,a,1972
1973,535,117,245,0,253050,253947,253050,t,1973
1974,319,1100,254655,0,1485,257559,254655,g,1974
1975,794,256,1141,0,256484,258675,256484,t,1975
1976,968,822,391,0,256505,258686,256505,t,1976
1977,949,420,1817,0,254878,258064,254878,t,1977
1978,400,219,1459,0,255861,257939,255861,t,1978
1979,255350,688,228,0,1419,257685,255350,a,1979
1980,500,295,256324,0,1337,258456,256324,g,1980
1981,1226,288,254380,0,516,256410,254380,g,1981
1982,1103,641,563,0,252469,254776,252469,t,1982
1983,1258,252857,401,0,1344,255860,252857,c,1983
1984,400,168,254874,0,4919,260361,254874,g,1984
1985,1365,258990,474,0,2008,262837,258990,c,1985
1986,1407,259146,1698,0,1101,263352,259146,c,1986
1987,1094,217,1137,0,259127,261575,259127,t,1987
1988,424,168,259148,0,4092,263832,259148,g,1988
1989,262351,973,742,0,1372,265438,262351,a,1989
1990,870,160,988,0,263786,265804,263786,t,1990
1991,978,703,752,0,262862,265295,262862,t,1991
1992,261493,598,719,0,870,263680,261493,a,1992
1993,1289,259914,1964,0,4523,267690,259914,c,1993
1994,267098,1061,755,0,5194,274108,267098,a,1994
1995,369,171,275181,0,474,276195,275181,g,1995
1996,1977,360,490,0,268682,271509,268682,t,1996
1997,1659,267005,2426,0,392,271482,267005,c,1997
1998,269011,635,745,0,835,271226,269011,a,1998
1999,267639,763,515,0,4443,273360,267639,a,1999
2000,1265,270565,1555,0,725,274110,270565,c,2000
2001,3022,265439,1822,0,1128,271411,265439,c,2001
2002,2536,264050,2810,0,439,269835,264050,c,2002
2003,265575,1339,1348,0,654,268916,265575,a,2003
2004,265676,1160,1298,0,526,268660,265676,a,2004
2005,425,148,674,0,267600,268847,267600,t,2005
2006,1502,265968,267,0,1135,268872,265968,c,2006
2007,392,146,268224,0,366,269128,268224,g,2007
2008,1543,515,1657,0,264823,268538,264823,t,2008
2009,265249,794,919,0,1274,268236,265249,a,2009
2010,266126,600,559,0,1209,268494,266126,a,2010
2011,1625,263484,2543,0,922,268574,263484,c,2011
2012,264495,661,2037,0,9184,276377,264495,a,2012
2013,473,157,280448,0,1671,282749,280448,g,2013
2014,280021,1289,1491,0,1883,284684,280021,a,2014
2015,282617,1009,1269,0,683,285578,282617,a,2015
2016,283116,1176,738,0,694,285724,283116,a,2016
2017,281723,1297,2033,0,1144,286197,281723,a,2017
2018,283339,1179,831,0,733,286082,283339,a,2018
2019,830,432,282369,0,729,284360,282369,g,2019
2020,279303,807,1050,0,638,281798,279303,a,2020
2021,553,269,2100,0,278088,281010,278088,t,2021
2022,274354,1436,208,0,2539,278537,274354,a,2022
2023,891,273,276303,0,2628,280095,276303,g,2023
2024,3240,272915,581,0,1411,278147,272915,c,2024
2025,2437,270176,1694,0,2923,277230,270176,c,2025
2026,2199,269201,1718,0,2440,275558,269201,c,2026
2027,265409,1518,2185,0,5936,275048,265409,a,2027
2028,1108,338,273767,0,1249,276462,273767,g,2028
2029,1979,510,946,0,266565,270000,266565,t,2029
2030,1940,265684,2249,0,655,270528,265684,c,2030
2031,265920,720,1923,0,941,269504,265920,a,2031
2032,265484,592,1462,0,3263,270801,265484,a,2032
2033,1600,265047,3867,0,1069,271583,265047,c,2033
2034,267553,812,1968,0,752,271085,267553,a,2034
2035,859,352,2326,0,267807,271344,267807,t,2035
2036,268154,1799,879,0,1001,271833,268154,a,2036
2037,1928,372,268401,0,1535,272236,268401,g,2037
2038,265187,1606,2224,0,4986,274003,265187,a,2038
2039,268709,1408,3202,0,4800,278119,268709,a,2039
2040,2412,584,274708,0,1828,279532,274708,g,2040
2041,4643,267800,1175,0,2707,276325,267800,c,2041
2042,273614,822,1484,0,680,276600,273614,a,2042
2043,1398,364,272543,0,780,275085,272543,g,2043
2044,270643,871,1057,0,537,273108,270643,a,2044
2045,263938,1057,4619,0,1307,270921,263938,a,2045
2046,1436,264207,952,0,7827,274422,264207,c,2046
2047,2354,267974,4418,0,538,275284,267974,c,2047
2048,658,552,1036,0,273111,275357,273111,t,2048
2049,2942,271259,507,0,840,275548,271259,c,2049
2050,1845,267632,3687,0,2505,275669,267632,c,2050
2051,270184,933,1656,0,1751,274524,270184,a,2051
2052,821,259,2009,0,271249,274338,271249,t,2052
2053,1589,284,704,0,272566,275143,272566,t,2053
2054,2521,270583,1446,0,976,275526,270583,c,2054
2055,800,248,274076,0,416,275540,274076,g,2055
2056,992,346,273385,0,531,275254,273385,g,2056
2057,270816,1262,949,0,2244,275271,270816,a,2057
2058,3316,389,270851,0,499,275055,270851,g,2058
2059,271240,975,847,0,3012,276074,271240,a,2059
2060,2364,270759,2579,0,1368,277070,270759,c,2060
2061,274015,1228,330,0,4039,279612,274015,a,2061
2062,689,264,278776,0,1993,281722,278776,g,2062
2063,1953,276484,1248,0,1349,281034,276484,c,2063
2064,1325,615,857,0,277484,280281,277484,t,2064
2065,277507,872,414,0,2898,281691,277507,a,2065
2066,1375,277641,2017,0,740,281773,277641,c,2066
2067,278891,1030,540,0,363,280824,278891,a,2067
2068,667,188,690,0,279254,280799,279254,t,2068
2069,1669,278225,637,0,535,281066,278225,c,2069
2070,276649,2016,1143,0,828,280636,276649,a,2070
2071,643,611,724,0,278846,280824,278846,t,2071
2072,1836,277430,1001,0,520,280787,277430,c,2072
2073,275726,1153,1318,0,594,278791,275726,a,2073
2074,772,360,1096,0,272372,274600,272372,t,2074
2075,270258,2496,479,0,1044,274277,270258,a,2075
2076,1000,301,272395,0,506,274202,272395,g,2076
2077,812,425,271250,0,897,273384,271250,g,2077
2078,270291,1706,456,0,1175,273628,270291,a,2078
2079,1505,294,271483,0,431,273713,271483,g,2079
2080,2366,545,988,0,268795,272694,268795,t,2080
2081,269979,2154,215,0,363,272711,269979,a,2081
2082,968,379,270888,0,526,272761,270888,g,2082
2083,268555,1661,322,0,2349,272887,268555,a,2083
2084,1510,375,270186,0,1852,273923,270186,g,2084
2085,2505,265433,154,0,5226,273318,265433,c,2085
2086,4236,268067,657,0,1388,274348,268067,c,2086
2087,1735,479,269313,0,11539,283066,269313,g,2087
2088,2176,387,280454,0,1528,284545,280454,g,2088
2089,1500,452,279502,0,472,281926,279502,g,2089
2090,258265,2289,487,0,1146,262187,258265,a,2090
2091,4785,247128,9338,0,965,262216,247128,c,2091
2092,258095,1554,1374,0,1564,262587,258095,a,2092
2093,251394,1836,1425,0,8724,263379,251394,a,2093
2094,1061,8550,4447,0,252867,266925,252867,t,2094
2095,1446,648,8912,0,257773,268779,257773,t,2095
2096,1160,414,266332,0,920,268826,266332,g,2096
2097,262478,706,593,0,3878,267655,262478,a,2097
2098,264593,1477,766,0,2021,268857,264593,a,2098
2099,903,713,266291,0,2330,270237,266291,g,2099
2100,11558,253446,1843,0,396,267243,253446,c,2100
2101,1134,707,9327,0,255239,266407,255239,t,2101
2102,2429,261589,1354,0,585,265957,261589,c,2102
2103,253273,1806,5793,0,1370,262242,253273,a,2103
2104,252946,1926,1691,0,5255,261818,252946,a,2104
2105,1601,253732,8341,0,455,264129,253732,c,2105
2106,2017,352,1955,0,256157,260481,256157,t,2106
2107,2121,4910,252273,0,2394,261698,252273,g,2107
2108,999,660,260374,0,1079,263112,260374,g,2108
2109,1491,906,2991,0,256839,262227,256839,t,2109
2110,1166,1099,8722,0,250945,261932,250945,t,2110
2111,2515,817,1912,0,255989,261233,255989,t,2111
2112,257245,1517,1553,0,399,260714,257245,a,2112
2113,250926,1945,6995,0,679,260545,250926,a,2113
2114,922,379,258438,0,709,260448,258438,g,2114
2115,251158,1598,4014,0,738,257508,251158,a,2115
2116,251106,1500,2589,0,977,256172,251106,a,2116
2117,249852,2197,1083,0,7612,260744,249852,a,2117
2118,4072,465,255931,0,1206,261674,255931,g,2118
2119,1478,323,253875,0,1214,256890,253875,g,2119
2120,251181,1327,1207,0,1912,255627,251181,a,2120
2121,249888,1222,2435,0,7234,260779,249888,a,2121
2122,1063,255,258236,0,1494,261048,258236,g,2122
2123,3992,486,1779,0,253716,259973,253716,t,2123
2124,832,642,1705,0,257149,260328,257149,t,2124
2125,2686,255486,924,0,868,259964,255486,c,2125
2126,657,242,1780,0,255921,258600,255921,t,2126
2127,250970,1626,1708,0,632,254936,250970,a,2127
2128,604,496,1119,0,251892,254111,251892,t,2128
2129,2139,246730,849,0,1601,251319,246730,c,2129
2130,705,225,247687,0,1395,250012,247687,g,2130
2131,1408,474,245689,0,1119,248690,245689,g,2131
2132,1716,241999,1868,0,2037,247620,241999,c,2132
2133,2853,239806,1255,0,1988,245902,239806,c,2133
2134,240490,585,2185,0,687,243947,240490,a,2134
2135,240053,1194,2032,0,563,243842,240053,a,2135
2136,240588,1468,1073,0,632,243761,240588,a,2136
2137,2144,692,1071,0,240136,244043,240136,t,2137
2138,522,680,242261,0,967,244430,242261,g,2138
2139,240930,1470,1500,0,651,244551,240930,a,2139
2140,1029,248,1599,0,242104,244980,242104,t,2140
2141,1277,1731,570,0,241910,245488,241910,t,2141
2142,717,391,242953,0,2149,246210,242953,g,2142
2143,241802,1663,730,0,2579,246774,241802,a,2143
2144,1117,318,245213,0,822,247470,245213,g,2144
2145,242012,1343,620,0,5839,249814,242012,a,2145
2146,2756,245817,1455,0,1593,251621,245817,c,2146
2147,245244,1865,1974,0,843,249926,245244,a,2147
2148,244294,845,2158,0,3215,250512,244294,a,2148
2149,1908,245798,2691,0,1178,251575,245798,c,2149
2150,244646,2206,2150,0,882,249884,244646,a,2150
2151,244996,1600,1806,0,1200,249602,244996,a,2151
2152,2405,728,916,0,245420,249469,245420,t,2152
2153,823,1057,245791,0,1392,249063,245791,g,2153
2154,242731,1726,1645,0,1441,247543,242731,a,2154
2155,1249,885,244187,0,1221,247542,244187,g,2155
2156,2892,1584,234507,0,1999,240982,234507,g,2156
2157,3319,454,231688,0,1212,236673,231688,g,2157
2158,1844,442,231249,0,2915,236450,231249,g,2158
2159,231492,2413,708,0,1871,236484,231492,a,2159
2160,1297,915,231744,0,3347,237303,231744,g,2160
2161,2930,228478,1497,0,2726,235631,228478,c,2161
2162,510,256,232954,0,1914,235634,232954,g,2162
2163,228282,1893,1064,0,4810,236049,228282,a,2163
2164,231325,3047,540,0,1465,236377,231325,a,2164
2165,1103,769,233188,0,2948,238008,233188,g,2165
2166,229102,1674,2055,0,2919,235750,229102,a,2166
2167,762,264,234259,0,1047,236332,234259,g,2167
2168,226575,2803,672,0,2439,232489,226575,a,2168
2169,225696,1637,2687,0,2608,232628,225696,a,2169
2170,2671,2155,2938,0,229569,237333,229569,t,2170
2171,2182,1949,229346,0,3506,236983,229346,g,2171
2172,3306,555,229457,0,1380,234698,229457,g,2172
2173,6826,212991,3681,0,1890,225388,212991,c,2173
2174,4080,205811,6058,0,2140,218089,205811,c,2174
2175,206757,2085,3964,0,1478,214284,206757,a,2175
2176,1379,695,4289,0,206998,213361,206998,t,2176
2177,1932,4290,1523,0,205680,213425,205680,t,2177
2178,922,1027,9086,0,202018,213053,202018,t,2178
2179,1011,1457,4527,0,205900,212895,205900,t,2179
2180,206829,1727,1701,0,1228,211485,206829,a,2180
2181,4202,605,205611,0,753,211171,205611,g,2181
2182,4014,519,193555,0,2016,200104,193555,g,2182
2183,7072,2503,3599,0,180643,193817,180643,t,2183
2184,2363,1222,191404,0,589,195578,191404,g,2184
2185,184031,3543,3345,0,4146,195065,184031,a,2185
2186,7922,181662,4267,0,1369,195220,181662,c,2186
2187,186081,1328,1806,0,4331,193546,186081,a,2187
2188,2618,181500,8328,0,939,193385,181500,c,2188
2189,185199,1646,3588,0,902,191335,185199,a,2189
2190,1223,363,185534,0,4036,191156,185534,g,2190
2191,2531,181132,4004,0,2527,190194,181132,c,2191
2192,1459,600,5131,0,182492,189682,182492,t,2192
2193,5092,1800,1472,0,180962,189326,180962,t,2193
2194,1910,1939,182509,0,1706,188064,182509,g,2194
2195,2449,382,183429,0,739,186999,183429,g,2195
2196,1502,310,181902,0,2280,185994,181902,g,2196
2197,181647,1718,1360,0,1291,186016,181647,a,2197
2198,3148,874,5194,0,177014,186230,177014,t,2198
2199,3614,2241,1343,0,178985,186183,178985,t,2199
2200,875,531,7302,0,177016,185724,177016,t,2200
2201,1960,1996,1492,0,180086,185534,180086,t,2201
2202,4235,1019,179536,0,600,185390,179536,g,2202
2203,826,307,182348,0,1381,184862,182348,g,2203
2204,179465,1451,1115,0,1330,183361,179465,a,2204
2205,1532,597,2105,0,179049,183283,179049,t,2205
2206,2370,177166,2050,0,1549,183135,177166,c,2206
2207,2418,174449,1253,0,5567,183687,174449,c,2207
2208,2290,179053,1428,0,1390,184161,179053,c,2208
2209,663,421,2665,0,180894,184643,180894,t,2209
2210,723,852,182239,0,1185,184999,182239,g,2210
2211,1398,246,174093,0,1590,177327,174093,g,2211
2212,1291,412,173472,0,1374,176549,173472,g,2212
2213,168486,2266,1429,0,2341,174522,168486,a,2213
2214,2741,626,170615,0,841,174823,170615,g,2214
2215,1169,716,171545,0,779,174209,171545,g,2215
2216,170134,2079,672,0,1445,174330,170134,a,2216
2217,639,533,172638,0,558,174368,172638,g,2217
2218,2459,2003,1284,0,168344,174090,168344,t,2218
2219,568,288,173479,0,4454,178789,173479,g,2219
2220,1358,647,702,0,177930,180637,177930,t,2220
2221,1251,774,1601,0,176687,180313,176687,t,2221
2222,645,447,1594,0,177582,180268,177582,t,2222
2223,176571,810,815,0,1684,179880,176571,a,2223
2224,1224,176720,1857,0,1082,180883,176720,c,2224
2225,176418,1202,1925,0,601,180146,176418,a,2225
2226,377,174,647,0,179228,180426,179228,t,2226
2227,1233,177239,1370,0,1221,181063,177239,c,2227
2228,590,366,849,0,178968,180773,178968,t,2228
2229,177227,1386,1336,0,713,180662,177227,a,2229
2230,454,224,991,0,178512,180181,178512,t,2230
2231,177563,1148,1764,0,3056,183531,177563,a,2231
2232,408,305,182802,0,1697,185212,182802,g,2232
2233,408,292,183926,0,1059,185685,183926,g,2233
2234,183147,1051,786,0,547,185531,183147,a,2234
2235,182937,1333,591,0,2152,187013,182937,a,2235
2236,185626,1248,399,0,936,188209,185626,a,2236
2237,838,382,186663,0,686,188569,186663,g,2237
2238,1543,454,183167,0,2231,187395,183167,g,2238
2239,2007,183700,1313,0,1357,188377,183700,c,2239
2240,481,486,573,0,189672,191212,189672,t,2240
2241,1016,189419,1146,0,1325,192906,189419,c,2241
2242,423,409,911,0,190881,192624,190881,t,2242
2243,1920,188668,858,0,1081,192527,188668,c,2243
2244,1812,188551,1406,0,749,192518,188551,c,2244
2245,189649,825,798,0,1489,192761,189649,a,2245
2246,1165,189772,727,0,2398,194062,189772,c,2246
2247,1138,191333,861,0,753,194085,191333,c,2247
2248,191334,1234,741,0,1246,194555,191334,a,2248
2249,191390,2435,454,0,1987,196266,191390,a,2249
2250,215,164,196598,0,279,197256,196598,g,2250
2251,792,315,658,0,195415,197180,195415,t,2251
2252,220,323,1261,0,195675,197479,195675,t,2252
2253,347,259,940,0,195959,197505,195959,t,2253
2254,781,157,385,0,196193,197516,196193,t,2254
2255,1040,194819,872,0,734,197465,194819,c,2255
2256,1027,280,193113,0,2102,196522,193113,g,2256
2257,543,321,178606,0,938,180408,178606,g,2257
2258,171790,1429,545,0,1373,175137,171790,a,2258
2259,723,222,173276,0,1583,175804,173276,g,2259
2260,1706,170000,1660,0,1143,174509,170000,c,2260
2261,168102,1425,3424,0,710,173661,168102,a,2261
2262,168071,1127,1828,0,2375,173401,168071,a,2262
2263,596,1855,1167,0,169745,173363,169745,t,2263
2264,1432,166100,4078,0,1466,173076,166100,c,2264
2265,871,341,2483,0,169328,173023,169328,t,2265
2266,166409,1319,3750,0,1424,172902,166409,a,2266
2267,1773,1034,2546,0,168190,173543,168190,t,2267
2268,4109,1141,164986,0,1291,171527,164986,g,2268
2269,1313,553,165163,0,2383,169412,165163,g,2269
2270,4015,623,162478,0,3080,170196,162478,g,2270
2271,2661,444,164345,0,2495,169945,164345,g,2271
2272,4497,161968,2332,0,994,169791,161968,c,2272
2273,3562,637,3424,0,161988,169611,161988,t,2273
2274,1265,598,165361,0,2501,169725,165361,g,2274
2275,2958,162798,2069,0,5728,173553,162798,c,2275
2276,2141,168220,4808,0,668,175837,168220,c,2276
2277,1311,497,1664,0,171888,175360,171888,t,2277
2278,1620,1265,2521,0,169970,175376,169970,t,2278
2279,1241,169079,2602,0,2433,175355,169079,c,2279
2280,171116,1613,942,0,3662,177333,171116,a,2280
2281,464,237,177067,0,755,178523,177067,g,2281
2282,2164,981,1459,0,173249,177853,173249,t,2282
2283,1820,1017,174669,0,799,178305,174669,g,2283
2284,1317,497,174807,0,1168,177789,174807,g,2284
2285,1801,681,173673,0,1261,177416,173673,g,2285
2286,1234,393,174517,0,343,176487,174517,g,2286
2287,1338,648,983,0,173171,176140,173171,t,2287
2288,1704,171250,949,0,677,174580,171250,c,2288
2289,910,295,898,0,173476,175579,173476,t,2289
2290,990,173763,823,0,973,176549,173763,c,2290
2291,173643,993,1526,0,1846,178008,173643,a,2291
2292,388,265,732,0,181546,182931,181546,t,2292
2293,365,562,183718,0,887,185532,183718,g,2293
2294,485,203,184286,0,519,185493,184286,g,2294
2295,182470,890,426,0,1336,185122,182470,a,2295
2296,913,183130,818,0,915,185776,183130,c,2296
2297,473,242,519,0,184694,185928,184694,t,2297
2298,184456,793,291,0,4805,190345,184456,a,2298
2299,328,167,659,0,193299,194453,193299,t,2299
2300,212,153,194541,0,1686,196592,194541,g,2300
2301,195333,719,679,0,749,197480,195333,a,2301
2302,196090,1006,391,0,564,198051,196090,a,2302
2303,196378,981,413,0,428,198200,196378,a,2303
2304,196368,961,363,0,362,198054,196368,a,2304
2305,228,100,593,0,196962,197883,196962,t,2305
2306,195891,717,257,0,1567,198432,195891,a,2306
2307,971,196937,686,0,310,198904,196937,c,2307
2308,586,159,237,0,197196,198178,197196,t,2308
2309,811,196309,622,0,1021,198763,196309,c,2309
2310,196765,912,749,0,610,199036,196765,a,2310
2311,226,168,534,0,197946,198874,197946,t,2311
2312,196612,1468,233,0,1185,199498,196612,a,2312
2313,511,260,198533,0,639,199943,198533,g,2313
2314,609,236,198229,0,827,199901,198229,g,2314
2315,195794,1699,425,0,4218,202136,195794,a,2315
2316,623,367,202332,0,447,203769,202332,g,2316
2317,1107,406,404,0,199991,201908,199991,t,2317
2318,688,198563,1004,0,1171,201426,198563,c,2318
2319,198854,787,1133,0,603,201377,198854,a,2319
2320,454,169,781,0,200260,201664,200260,t,2320
2321,635,647,960,0,199623,201865,199623,t,2321
2322,196592,691,613,0,498,198394,196592,a,2322
2323,347,147,1378,0,198438,200310,198438,t,2323
2324,1432,197744,461,0,513,200150,197744,c,2324
2325,196501,640,1655,0,2345,201141,196501,a,2325
2326,784,197130,1962,0,956,200832,197130,c,2326
2327,193881,916,1277,0,639,196713,193881,a,2327
2328,641,1095,830,0,193852,196418,193852,t,2328
2329,461,615,195068,0,743,196887,195068,g,2329
2330,359,260,195427,0,2112,198158,195427,g,2330
2331,194131,1413,1466,0,1160,198170,194131,a,2331
2332,959,368,639,0,196196,198162,196196,t,2332
2333,194869,1858,770,0,1334,198831,194869,a,2333
2334,410,403,197597,0,1827,200237,197597,g,2334
2335,544,218,199051,0,15184,214997,199051,g,2335
2336,217733,1237,753,0,2531,222254,217733,a,2336
2337,220590,897,950,0,2138,224575,220590,a,2337
2338,2557,286,1365,0,221721,225929,221721,t,2338
2339,1075,200,224576,0,1725,227576,224576,g,2339
2340,225237,752,1134,0,2038,229161,225237,a,2340
2341,224665,1671,2634,0,572,229542,224665,a,2341
2342,770,263,1609,0,226697,229339,226697,t,2342
2343,544,221,1105,0,226703,228573,226703,t,2343
2344,1511,225245,668,0,1021,228445,225245,c,2344
2345,223601,703,1435,0,2709,228448,223601,a,2345
2346,1134,223641,807,0,1519,227101,223641,c,2346
2347,1151,242,220944,0,1215,223552,220944,g,2347
2348,2385,210501,2799,0,1587,217272,210501,c,2348
2349,212750,703,1166,0,1679,216298,212750,a,2349
2350,954,252,213450,0,1198,215854,213450,g,2350
2351,3126,209116,2206,0,559,215007,209116,c,2351
2352,208408,662,3245,0,6166,218481,208408,a,2352
2353,1250,215151,2298,0,4053,222752,215151,c,2353
2354,3035,217614,2058,0,819,223526,217614,c,2354
2355,1348,458,1714,0,220538,224058,220538,t,2355
2356,1160,220387,1478,0,1372,224397,220387,c,2356
2357,220479,1334,1408,0,876,224097,220479,a,2357
2358,842,218965,3317,0,1675,224799,218965,c,2358
2359,814,1651,646,0,222995,226106,222995,t,2359
2360,316,183,225491,0,508,226498,225491,g,2360
2361,541,394,358,0,224690,225983,224690,t,2361
2362,2067,221770,981,0,1389,226207,221770,c,2362
2363,466,286,1706,0,223531,225989,223531,t,2363
2364,1452,293,222898,0,994,225637,222898,g,2364
2365,872,429,1449,0,221968,224718,221968,t,2365
2366,695,614,222237,0,379,223925,222237,g,2366
2367,833,298,1129,0,221061,223321,221061,t,2367
2368,2074,220108,642,0,460,223284,220108,c,2368
2369,220064,1156,942,0,5361,227523,220064,a,2369
2370,1786,225717,942,0,591,229036,225717,c,2370
2371,370,162,1327,0,225358,227217,225358,t,2371
2372,224502,1134,387,0,732,226755,224502,a,2372
2373,162,139,226208,0,301,226810,226208,g,2373
2374,936,520,346,0,225083,226885,225083,t,2374
2375,223977,1289,1117,0,434,226817,223977,a,2375
2376,185,206,437,0,225963,226791,225963,t,2376
2377,957,627,153,0,225277,227014,225277,t,2377
2378,184,236,226226,0,1657,228303,226226,g,2378
2379,1049,207,226177,0,1200,228633,226177,g,2379
2380,1890,1047,452,0,225391,228780,225391,t,2380
2381,343,1006,226425,0,2678,230452,226425,g,2381
2382,856,195,227413,0,741,229205,227413,g,2382
2383,451,255,227718,0,744,229168,227718,g,2383
2384,225346,1818,634,0,2332,230130,225346,a,2384
2385,747,215,229093,0,512,230567,229093,g,2385
2386,663,458,428,0,229278,230827,229278,t,2386
2387,1008,229479,345,0,1708,232540,229479,c,2387
2388,241,208,231851,0,1917,234217,231851,g,2388
2389,1105,545,661,0,232410,234721,232410,t,2389
2390,618,270,233047,0,696,234631,233047,g,2390
2391,229974,1414,320,0,1311,233019,229974,a,2391
2392,1716,230189,851,0,1162,233918,230189,c,2392
2393,969,341,229507,0,1067,231884,229507,g,2393
2394,1197,227433,1398,0,1611,231639,227433,c,2394
2395,425,1670,903,0,228630,231628,228630,t,2395
2396,590,343,229904,0,375,231212,229904,g,2396
2397,1374,696,864,0,227750,230684,227750,t,2397
2398,226891,1768,1363,0,525,230547,226891,a,2398
2399,533,185,1339,0,228049,230106,228049,t,2399
2400,1814,624,465,0,227247,230150,227247,t,2400
2401,642,475,1737,0,228342,231196,228342,t,2401
2402,284,820,229334,0,1223,231661,229334,g,2402
2403,776,387,228734,0,557,230454,228734,g,2403
2404,834,197,227374,0,986,229391,227374,g,2404
2405,215378,2519,617,0,2137,220651,215378,a,2405
2406,769,352,219487,0,422,221030,219487,g,2406
2407,4667,490,1450,0,212395,219002,212395,t,2407
2408,815,723,1503,0,215766,218807,215766,t,2408
2409,213056,2317,2462,0,713,218548,213056,a,2409
2410,772,390,1803,0,215230,218195,215230,t,2410
2411,1039,3376,211701,0,1619,217735,211701,g,2411
2412,1166,237,215652,0,1105,218160,215652,g,2412
2413,2064,783,960,0,213853,217660,213853,t,2413
2414,945,437,214272,0,2141,217795,214272,g,2414
2415,1882,210899,992,0,4139,217912,210899,c,2415
2416,214782,1221,935,0,1654,218592,214782,a,2416
2417,574,810,216764,0,991,219139,216764,g,2417
2418,1594,345,210304,0,1467,213710,210304,g,2418
2419,1576,205056,3390,0,2898,212920,205056,c,2419
2420,4879,206120,601,0,643,212243,206120,c,2420
2421,2675,179,208641,0,565,212060,208641,g,2421
2422,207500,1454,1819,0,905,211678,207500,a,2422
2423,1524,304,3131,0,207013,211972,207013,t,2423
2424,208494,2415,457,0,887,212253,208494,a,2424
2425,310,154,211463,0,607,212534,211463,g,2425
2426,1819,778,2545,0,207413,212555,207413,t,2426
2427,1409,488,209742,0,4350,215989,209742,g,2427
2428,2332,348,214065,0,1276,218021,214065,g,2428
2429,2079,475,1790,0,212713,217057,212713,t,2429
2430,2379,1874,719,0,211925,216897,211925,t,2430
2431,553,412,214224,0,1407,216596,214224,g,2431
2432,1548,212182,607,0,1720,216057,212182,c,2432
2433,229,296,214902,0,298,215725,214902,g,2433
2434,619,370,1313,0,212836,215138,212836,t,2434
2435,865,1715,711,0,212931,216222,212931,t,2435
2436,319,171,214637,0,879,216006,214637,g,2436
2437,1079,353,1587,0,212523,215542,212523,t,2437
2438,321,173,213871,0,951,215316,213871,g,2438
2439,208004,1640,545,0,1286,211475,208004,a,2439
2440,1129,151,208769,0,1106,211155,208769,g,2440
2441,2426,202594,983,0,919,206922,202594,c,2441
2442,350,1604,1555,0,205746,209255,205746,t,2442
2443,593,538,206993,0,2392,210516,206993,g,2443
2444,1276,209,199687,0,691,201863,199687,g,2444
2445,194326,1476,1487,0,1027,198316,194326,a,2445
2446,193495,1330,2712,0,1076,198613,193495,a,2446
2447,192001,1146,4309,0,632,198088,192001,a,2447
2448,193979,1107,903,0,1966,197955,193979,a,2448
2449,190665,2456,4200,0,1264,198585,190665,a,2449
2450,1202,193208,3052,0,3527,200989,193208,c,2450
2451,195464,1019,4049,0,745,201277,195464,a,2451
2452,196364,728,1868,0,2107,201067,196364,a,2452
2453,197672,2191,522,0,1019,201404,197672,a,2453
2454,652,156,200244,0,544,201596,200244,g,2454
2455,196158,986,707,0,2277,200128,196158,a,2455
2456,193978,1509,3159,0,4336,202982,193978,a,2456
2457,1387,199130,2559,0,1234,204310,199130,c,2457
2458,783,239,2398,0,199553,202973,199553,t,2458
2459,454,801,201223,0,662,203140,201223,g,2459
2460,197192,1267,1072,0,2787,202318,197192,a,2460
2461,198806,1764,1234,0,535,202339,198806,a,2461
2462,773,211,200157,0,581,201722,200157,g,2462
2463,2852,866,2823,0,194130,200671,194130,t,2463
2464,578,534,199244,0,708,201064,199244,g,2464
2465,2430,1707,1329,0,195456,200922,195456,t,2465
2466,2397,934,197302,0,394,201027,197302,g,2466
2467,2377,218,191880,0,1387,195862,191880,g,2467
2468,5548,172275,3098,0,1184,182105,172275,c,2468
2469,171070,1673,4332,0,4541,181616,171070,a,2469
2470,3442,488,177380,0,1517,182827,177380,g,2470
2471,2521,1636,2176,0,179216,185549,179216,t,2471
2472,785,4335,181437,0,1308,187865,181437,g,2472
2473,1522,501,182136,0,1307,185466,182136,g,2473
2474,696,237,182958,0,1013,184904,182958,g,2474
2475,177885,2115,2287,0,1438,183725,177885,a,2475
2476,4029,492,1769,0,176540,182830,176540,t,2476
2477,696,1935,4550,0,175768,182949,175768,t,2477
2478,3463,382,1791,0,177300,182936,177300,t,2478
2479,1067,390,3844,0,177447,182748,177447,t,2479
2480,1460,178607,1598,0,1526,183191,178607,c,2480
2481,175244,1292,5018,0,421,181975,175244,a,2481
2482,740,197,1016,0,180777,182730,180777,t,2482
2483,1729,178792,1497,0,1318,183336,178792,c,2483
2484,177162,1849,2074,0,3367,184452,177162,a,2484
2485,2529,177804,3101,0,2590,186024,177804,c,2485
2486,179744,1756,4029,0,382,185911,179744,a,2486
2487,1279,240,183742,0,623,185884,183742,g,2487
2488,178324,1133,1554,0,708,181719,178324,a,2488
2489,5105,172937,2963,0,323,181328,172937,c,2489
2490,177141,1384,1413,0,195,180133,177141,a,2490
2491,174505,718,2624,0,3199,181046,174505,a,2491
2492,5711,174553,470,0,1696,182430,174553,c,2492
2493,973,890,178578,0,957,181398,178578,g,2493
2494,2500,788,1653,0,176015,180956,176015,t,2494
2495,824,352,179099,0,1988,182263,179099,g,2495
2496,3248,173511,906,0,2594,180259,173511,c,2496
2497,173507,1457,1520,0,568,177052,173507,a,2497
2498,2883,167592,4515,0,681,175671,167592,c,2498
2499,168564,1224,1402,0,2047,173237,168564,a,2499
2500,2264,166406,2256,0,2332,173258,166406,c,2500
2501,167083,2821,2327,0,477,172708,167083,a,2501
2502,1394,750,1584,0,169602,173330,169602,t,2502
2503,944,1986,170049,0,1122,174101,170049,g,2503
2504,961,174,169293,0,2027,172455,169293,g,2504
2505,167262,1264,2389,0,2460,173375,167262,a,2505
2506,4161,165104,3200,0,1119,173584,165104,c,2506
2507,158624,1608,3580,0,6742,170554,158624,a,2507
2508,714,198,171122,0,1104,173138,171122,g,2508
2509,169580,1581,840,0,912,172913,169580,a,2509
2510,166443,789,2009,0,3541,172782,166443,a,2510
2511,4018,165782,2127,0,1006,172933,165782,c,2511
2512,163471,1659,4435,0,678,170243,163471,a,2512
2513,164579,975,3832,0,1051,170437,164579,a,2513
2514,3356,957,3511,0,163992,171816,163992,t,2514
2515,167725,969,1549,0,4244,174487,167725,a,2515
2516,3183,165802,4929,0,1046,174960,165802,c,2516
2517,169469,1322,2098,0,1727,174616,169469,a,2517
2518,169175,1302,2738,0,3476,176691,169175,a,2518
2519,1142,1709,174324,0,654,177829,174324,g,2519
2520,3113,704,3082,0,170155,177054,170155,t,2520
2521,1005,412,1954,0,173168,176539,173168,t,2521
2522,2036,171262,1583,0,1176,176057,171262,c,2522
2523,1596,169390,3325,0,1593,175904,169390,c,2523
2524,169893,1621,1582,0,981,174077,169893,a,2524
2525,169762,667,1961,0,4972,177362,169762,a,2525
2526,3411,173033,1641,0,2078,180163,173033,c,2526
2527,2274,170538,2270,0,1268,176350,170538,c,2527
2528,172308,873,2706,0,570,176457,172308,a,2528
2529,1426,296,174389,0,265,176376,174389,g,2529
2530,171539,1162,1445,0,1436,175582,171539,a,2530
2531,172458,855,1600,0,317,175230,172458,a,2531
2532,1990,564,1668,0,171745,175967,171745,t,2532
2533,2942,172170,842,0,734,176688,172170,c,2533
2534,1855,171060,2385,0,1135,176435,171060,c,2534
2535,1966,171821,631,0,9800,184218,171821,c,2535
2536,1017,182582,2127,0,3070,188796,182582,c,2536
2537,1469,701,1682,0,182033,185885,182033,t,2537
2538,712,746,1324,0,183271,186053,183271,t,2538
2539,1356,182381,1897,0,700,186334,182381,c,2539
2540,182810,1258,1387,0,891,186346,182810,a,2540
2541,183470,1077,1498,0,1014,187059,183470,a,2541
2542,184982,1128,901,0,2015,189026,184982,a,2542
2543,1149,472,187667,0,934,190222,187667,g,2543
2544,1969,185565,1072,0,236,188842,185565,c,2544
2545,973,400,1482,0,185843,188698,185843,t,2545
2546,186759,1351,314,0,739,189163,186759,a,2546
2547,955,578,187112,0,856,189501,187112,g,2547
2548,1774,183971,1077,0,541,187363,183971,c,2548
2549,811,396,1840,0,184042,187089,184042,t,2549
2550,555,377,1018,0,186613,188563,186613,t,2550
2551,1431,186785,440,0,816,189472,186785,c,2551
2552,186725,1370,1499,0,689,190283,186725,a,2552
2553,853,388,187879,0,1168,190288,187879,g,2553
2554,1257,186397,1686,0,398,189738,186397,c,2554
2555,658,251,819,0,187591,189319,187591,t,2555
2556,187384,795,558,0,260,188997,187384,a,2556
2557,1203,214,1006,0,186762,189185,186762,t,2557
2558,1588,186486,820,0,2419,191313,186486,c,2558
2559,1247,189049,1520,0,929,192745,189049,c,2559
2560,190252,850,859,0,1016,192977,190252,a,2560
2561,1427,158,191400,0,428,193413,191400,g,2561
2562,191389,901,355,0,454,193099,191389,a,2562
2563,190811,821,1151,0,1183,193966,190811,a,2563
2564,192657,970,227,0,467,194321,192657,a,2564
2565,1044,336,192382,0,2097,195859,192382,g,2565
2566,1526,193707,363,0,630,196226,193707,c,2566
2567,729,515,695,0,195402,197341,195402,t,2567
2568,1087,195570,368,0,735,197760,195570,c,2568
2569,194889,1019,952,0,1184,198044,194889,a,2569
2570,543,322,497,0,196587,197949,196587,t,2570
2571,633,338,196360,0,429,197760,196360,g,2571
2572,195319,813,377,0,666,197175,195319,a,2572
2573,195368,1076,254,0,536,197234,195368,a,2573
2574,1244,382,194944,0,759,197329,194944,g,2574
2575,194042,1414,481,0,3751,199688,194042,a,2575
2576,736,362,198807,0,2128,202033,198807,g,2576
2577,1288,541,196423,0,706,198958,196423,g,2577
2578,938,361,195731,0,1683,198713,195731,g,2578
2579,1419,195224,463,0,1112,198218,195224,c,2579
2580,194832,1429,986,0,389,197636,194832,a,2580
2581,737,262,971,0,195695,197665,195695,t,2581
2582,880,800,1023,0,195013,197716,195013,t,2582
2583,422,301,789,0,200782,202294,200782,t,2583
2584,817,536,201943,0,532,203828,201943,g,2584
2585,1259,552,1073,0,201542,204426,201542,t,2585
2586,870,267,203306,0,480,204923,203306,g,2586
2587,798,152,202647,0,513,204110,202647,g,2587
2588,201652,877,357,0,671,203557,201652,a,2588
2589,201054,1128,713,0,248,203143,201054,a,2589
2590,1241,353,608,0,201956,204158,201956,t,2590
2591,953,202051,924,0,1355,205283,202051,c,2591
2592,1656,202928,594,0,563,205741,202928,c,2592
2593,245,296,204118,0,1060,205719,204118,g,2593
2594,1105,202935,505,0,1013,205558,202935,c,2594
2595,996,1424,818,0,199769,203007,199769,t,2595
2596,1283,197474,1047,0,915,200719,197474,c,2596
2597,197421,828,1320,0,805,200374,197421,a,2597
2598,673,164,199060,0,547,200444,199060,g,2598
2599,990,743,921,0,197831,200485,197831,t,2599
2600,198291,993,958,0,299,200541,198291,a,2600
2601,197487,611,1563,0,4630,204291,197487,a,2601
2602,1769,202334,859,0,588,205550,202334,c,2602
2603,202890,746,1024,0,276,204936,202890,a,2603
2604,202375,1251,252,0,651,204529,202375,a,2604
2605,1126,260,202936,0,206,204528,202936,g,2605
2606,198744,1235,223,0,1771,201973,198744,a,2606
2607,1659,197602,1755,0,1339,202355,197602,c,2607
2608,512,1518,1090,0,203365,206485,203365,t,2608
2609,309,208,207356,0,1140,209013,207356,g,2609
2610,392,194,206971,0,1195,208752,206971,g,2610
2611,205483,1150,442,0,522,207597,205483,a,2611
2612,204459,1387,1173,0,367,207386,204459,a,2612
2613,202275,980,2303,0,557,206115,202275,a,2613
2614,203424,1310,830,0,439,206003,203424,a,2614
2615,827,285,1691,0,204310,207113,204310,t,2615
2616,1136,205166,710,0,768,207780,205166,c,2616
2617,422,258,1615,0,205015,207310,205015,t,2617
2618,420,1383,203494,0,422,205719,203494,g,2618
2619,199862,914,1899,0,1011,203686,199862,a,2619
2620,689,424,952,0,204105,206170,204105,t,2620
2621,973,363,201824,0,1005,204165,201824,g,2621
2622,912,660,827,0,202145,204544,202145,t,2622
2623,528,1006,202664,0,1260,205458,202664,g,2623
2624,490,218,203646,0,1016,205370,203646,g,2624
2625,199982,1084,1334,0,829,203229,199982,a,2625
2626,199029,1148,1132,0,526,201835,199029,a,2626
2627,198329,994,955,0,934,201212,198329,a,2627
2628,1120,195289,3078,0,950,200437,195289,c,2628
2629,195172,430,1267,0,679,197548,195172,a,2629
2630,192702,838,2713,0,2084,198337,192702,a,2630
2631,195238,1046,1066,0,1516,198866,195238,a,2631
2632,657,208,2879,0,193608,197352,193608,t,2632
2633,186508,805,441,0,1086,188840,186508,a,2633
2634,185232,955,1960,0,1305,189452,185232,a,2634
2635,1313,183223,4267,0,466,189269,183223,c,2635
2636,182174,666,1351,0,6146,190337,182174,a,2636
2637,1213,186635,1894,0,4158,193900,186635,c,2637
2638,1592,190534,1501,0,538,194165,190534,c,2638
2639,188678,839,2744,0,1530,193791,188678,a,2639
2640,555,502,191968,0,510,193535,191968,g,2640
2641,189435,945,920,0,2214,193514,189435,a,2641
2642,189971,926,2161,0,618,193676,189971,a,2642
2643,537,533,2897,0,188685,192652,188685,t,2643
2644,1810,559,2431,0,187375,192175,187375,t,2644
2645,935,204,190304,0,631,192074,190304,g,2645
2646,187436,1752,1072,0,1471,191731,187436,a,2646
2647,188924,1039,1687,0,805,192455,188924,a,2647
2648,1364,249,878,0,190372,192863,190372,t,2648
2649,1611,188570,1387,0,461,192029,188570,c,2649
2650,188459,857,1534,0,1182,192032,188459,a,2650
2651,882,187426,2229,0,1948,192485,187426,c,2651
2652,189297,842,1755,0,972,192866,189297,a,2652
2653,375,111,2288,0,189750,192524,189750,t,2653
2654,717,705,443,0,190726,192591,190726,t,2654
2655,1596,188965,1775,0,394,192730,188965,c,2655
2656,379,127,1757,0,190500,192763,190500,t,2656
2657,189805,661,925,0,750,192141,189805,a,2657
2658,479,129,894,0,192569,194071,192569,t,2658
2659,1503,192497,293,0,1420,195713,192497,c,2659
2660,193859,442,1021,0,699,196021,193859,a,2660
2661,283,188,194989,0,252,195712,194989,g,2661
2662,193101,611,1235,0,342,195289,193101,a,2662
2663,193347,675,1015,0,378,195415,193347,a,2663
2664,193110,1123,609,0,374,195216,193110,a,2664
2665,193178,1086,469,0,316,195049,193178,a,2665
2666,941,273,313,0,193115,194642,193115,t,2666
2667,411,196,192229,0,235,193071,192229,g,2667
2668,191018,922,271,0,1132,193343,191018,a,2668
2669,477,265,191781,0,4865,197388,191781,g,2669
2670,981,1024,192405,0,674,195084,192405,g,2670
2671,2381,619,2011,0,190256,195267,190256,t,2671
2672,620,240,192961,0,501,194322,192961,g,2672
2673,192170,655,219,0,1008,194052,192170,a,2673
2674,192461,795,262,0,4589,198107,192461,a,2674
2675,372,179,199749,0,272,200572,199749,g,2675
2676,1506,326,1035,0,197385,200252,197385,t,2676
2677,534,1198,575,0,198725,201032,198725,t,2677
2678,512,404,200110,0,296,201322,200110,g,2678
2679,198633,665,272,0,2118,201688,198633,a,2679
2680,941,199854,864,0,421,202080,199854,c,2680
2681,1416,267,1118,0,193992,196793,193992,t,2681
2682,193194,417,1611,0,716,195938,193194,a,2682
2683,1325,96,1507,0,192226,195154,192226,t,2683
2684,751,383,516,0,193086,194736,193086,t,2684
2685,191615,1530,544,0,1102,194791,191615,a,2685
2686,1384,203,1988,0,189523,193098,189523,t,2686
2687,493,252,187873,0,259,188877,187873,g,2687
2688,186043,426,840,0,1012,188321,186043,a,2688
2689,2736,183431,1057,0,1621,188845,183431,c,2689
2690,179625,1391,2396,0,1178,184590,179625,a,2690
2691,2088,172,181426,0,1895,185581,181426,g,2691
2692,2304,278,181575,0,2314,186471,181575,g,2692
2693,183203,2682,443,0,447,186775,183203,a,2693
2694,1469,425,184307,0,462,186663,184307,g,2694
2695,179533,876,322,0,4785,185516,179533,a,2695
2696,795,182091,2068,0,1878,186832,182091,c,2696
2697,180693,1429,4593,0,284,186999,180693,a,2697
2698,246,109,999,0,187365,188719,187365,t,2698
2699,1127,184349,3884,0,4696,194056,184349,c,2699
2700,189685,789,1626,0,8054,200154,189685,a,2700
2701,199965,884,1086,0,1593,203528,199965,a,2701
2702,197674,742,4740,0,1181,204337,197674,a,2702
2703,2281,229,201545,0,1343,205398,201545,g,2703
2704,2903,227,191816,0,703,195649,191816,g,2704
2705,190284,1938,2473,0,587,195282,190284,a,2705
2706,191432,621,2283,0,266,194602,191432,a,2706
2707,3243,286,599,0,191274,195402,191274,t,2707
2708,1443,188666,2547,0,630,193286,188666,c,2708
2709,186981,502,4158,0,905,192546,186981,a,2709
2710,1668,628,1035,0,188723,192054,188723,t,2710
2711,676,249,189888,0,978,191791,189888,g,2711
2712,2101,181041,751,0,5612,189505,181041,c,2712
2713,184344,684,1928,0,1082,188038,184344,a,2713
2714,936,340,183618,0,1770,186664,183618,g,2714
2715,3076,333,177704,0,985,182098,177704,g,2715
2716,2089,170412,3238,0,5085,180824,170412,c,2716
2717,175068,2037,764,0,3069,180938,175068,a,2717
2718,1154,354,179484,0,1301,182293,179484,g,2718
2719,1752,363,177236,0,1518,180869,177236,g,2719
2720,171632,921,4257,0,12731,189541,171632,a,2720
2721,189994,886,1732,0,3148,195760,189994,a,2721
2722,191357,626,3391,0,1402,196776,191357,a,2722
2723,192771,740,1318,0,2980,197809,192771,a,2723
2724,5009,189528,2783,0,2365,199685,189528,c,2724
2725,1608,1333,195084,0,1224,199249,195084,g,2725
2726,193389,1075,2189,0,1196,197849,193389,a,2726
2727,1287,938,1338,0,195461,199024,195461,t,2727
2728,2000,194330,1680,0,906,198916,194330,c,2728
2729,765,713,859,0,196129,198466,196129,t,2729
2730,1545,194595,1844,0,1097,199081,194595,c,2730
2731,686,410,3263,0,194486,198845,194486,t,2731
2732,1112,296,196123,0,687,198218,196123,g,2732
2733,1948,189336,1040,0,3042,195366,189336,c,2733
2734,191103,965,2222,0,278,194568,191103,a,2734
2735,1360,555,191316,0,1181,194412,191316,g,2735
2736,1891,186866,1261,0,1685,191703,186866,c,2736
2737,1654,186786,1280,0,1235,190955,186786,c,2737
2738,1723,186926,1049,0,2019,191717,186926,c,2738
2739,1585,188909,794,0,1573,192861,188909,c,2739
2740,190505,1345,812,0,1534,194196,190505,a,2740
2741,1532,400,192081,0,716,194729,192081,g,2741
2742,2211,190292,572,0,904,193979,190292,c,2742
2743,1737,187314,1611,0,1421,192083,187314,c,2743
2744,1879,183973,1264,0,1525,188641,183973,c,2744
2745,184550,1438,1457,0,4464,191909,184550,a,2745
2746,2675,188465,1284,0,1759,194183,188465,c,2746
2747,2128,810,1181,0,189345,193464,189345,t,2747
2748,638,577,191864,0,1261,194340,191864,g,2748
2749,190312,1243,1942,0,1273,194770,190312,a,2749
2750,1542,561,191398,0,3407,196908,191398,g,2750
2751,1580,192457,1771,0,1942,197750,192457,c,2751
2752,1261,329,2006,0,194765,198361,194765,t,2752
2753,678,390,196443,0,1467,198978,196443,g,2753
2754,195061,1396,838,0,1630,198925,195061,a,2754
2755,194931,1285,1865,0,1033,199114,194931,a,2755
2756,993,405,196407,0,1405,199210,196407,g,2756
2757,3226,1316,2063,0,191682,198287,191682,t,2757
2758,191262,1559,2698,0,2862,198381,191262,a,2758
2759,1262,467,1777,0,194555,198061,194555,t,2759
2760,696,245,1603,0,195336,197880,195336,t,2760
2761,2048,191646,1497,0,2409,197600,191646,c,2761
2762,189689,1696,1109,0,2902,195396,189689,a,2762
2763,1518,1114,1725,0,194915,199272,194915,t,2763
2764,602,571,199502,0,1590,202265,199502,g,2764
2765,581,482,199855,0,1766,202684,199855,g,2765
2766,197971,1653,1663,0,1183,202470,197971,a,2766
2767,198514,802,1929,0,1085,202330,198514,a,2767
2768,197518,797,2228,0,1552,202095,197518,a,2768
2769,197701,687,2117,0,2610,203115,197701,a,2769
2770,2835,197605,1894,0,1292,203626,197605,c,2770
2771,194662,1699,2733,0,2489,201583,194662,a,2771
2772,1081,944,1424,0,198303,201752,198303,t,2772
2773,1268,1598,196788,0,1736,201390,196788,g,2773
2774,887,904,196975,0,6536,205302,196975,g,2774
2775,1402,897,202277,0,2268,206844,202277,g,2775
2776,944,637,202829,0,1896,206306,202829,g,2776
2777,2755,199367,1671,0,2685,206478,199367,c,2777
2778,202067,1811,928,0,2511,207317,202067,a,2778
2779,202504,1661,1609,0,3866,209640,202504,a,2779
2780,206434,1826,1000,0,2891,212151,206434,a,2780
2781,963,759,209483,0,5093,216298,209483,g,2781
2782,1657,212970,1223,0,1727,217577,212970,c,2782
2783,865,478,215505,0,761,217609,215505,g,2783
2784,211397,1786,1135,0,2322,216640,211397,a,2784
2785,213329,1213,1229,0,1141,216912,213329,a,2785
2786,212405,1723,1291,0,1465,216884,212405,a,2786
2787,211721,1383,1410,0,2230,216744,211721,a,2787
2788,1193,452,697,0,214512,216854,214512,t,2788
2789,560,613,214724,0,1245,217142,214724,g,2789
2790,1996,211567,1460,0,2576,217599,211567,c,2790
2791,1080,1371,1325,0,213908,217684,213908,t,2791
2792,1345,212300,1029,0,2499,217173,212300,c,2792
2793,575,497,930,0,214970,216972,214970,t,2793
2794,1161,211656,1227,0,2935,216979,211656,c,2794
2795,844,602,1176,0,214640,217262,214640,t,2795
2796,212978,1037,1372,0,2703,218090,212978,a,2796
2797,2152,213923,1534,0,1076,218685,213923,c,2797
2798,214436,2099,1280,0,751,218566,214436,a,2798
2799,1203,484,216220,0,603,218510,216220,g,2799
2800,214101,1507,1000,0,1678,218286,214101,a,2800
2801,1407,588,214469,0,1586,218050,214469,g,2801
2802,1054,636,557,0,216649,218896,216649,t,2802
2803,1269,214603,1182,0,2729,219783,214603,c,2803
2804,575,654,986,0,220689,222904,220689,t,2804
2805,1281,219755,1520,0,1255,223811,219755,c,2805
2806,218854,1664,1858,0,1315,223691,218854,a,2806
2807,1621,256,1170,0,219018,222065,219018,t,2807
2808,216082,919,1802,0,1334,220137,216082,a,2808
2809,214969,859,989,0,2601,219418,214969,a,2809
2810,2229,212890,1503,0,5260,221882,212890,c,2810
2811,2063,218022,1281,0,1487,222853,218022,c,2811
2812,219264,1428,1728,0,1354,223774,219264,a,2812
2813,1532,307,221550,0,740,224129,221550,g,2813
2814,218254,1842,1537,0,1595,223228,218254,a,2814
2815,2181,216798,2948,0,2872,224799,216798,c,2815
2816,1800,218671,1618,0,3275,225364,218671,c,2816
2817,863,401,2027,0,222593,225884,222593,t,2817
2818,656,411,1398,0,223919,226384,223919,t,2818
2819,907,1084,840,0,224864,227695,224864,t,2819
2820,1498,221464,2838,0,2483,228283,221464,c,2820
2821,1102,654,1722,0,223911,227389,223911,t,2821
2822,1714,220683,2164,0,2658,227219,220683,c,2822
2823,220429,1336,2140,0,2524,226429,220429,a,2823
2824,902,386,1627,0,222902,225817,222902,t,2824
2825,953,993,1691,0,221938,225575,221938,t,2825
2826,836,660,221178,0,2537,225211,221178,g,2826
2827,216781,1635,1321,0,2555,222292,216781,a,2827
2828,1685,695,2289,0,217391,222060,217391,t,2828
2829,2315,701,215296,0,2284,220596,215296,g,2829
2830,2206,542,213886,0,3006,219640,213886,g,2830
2831,2788,212221,1987,0,3917,220913,212221,c,2831
2832,3683,212919,2132,0,5094,223828,212919,c,2832
2833,1553,218253,1292,0,5668,226766,218253,c,2833
2834,1294,221718,2146,0,2359,227517,221718,c,2834
2835,1078,942,223852,0,1311,227183,223852,g,2835
2836,220560,1802,3201,0,1298,226861,220560,a,2836
2837,220992,1689,1351,0,1448,225480,220992,a,2837
2838,220371,1468,931,0,3951,226721,220371,a,2838
2839,2012,221733,3272,0,1885,228902,221733,c,2839
2840,225216,934,1339,0,2453,229942,225216,a,2840
2841,1268,440,228074,0,1628,231410,228074,g,2841
2842,2491,225766,1092,0,1842,231191,225766,c,2842
2843,223610,2019,2647,0,1676,229952,223610,a,2843
2844,1180,338,226212,0,2332,230062,226212,g,2844
2845,223189,2573,558,0,2200,228520,223189,a,2845
2846,221093,1220,3195,0,2940,228448,221093,a,2846
2847,1586,1412,986,0,223917,227901,223917,t,2847
2848,1810,448,223403,0,2335,227996,223403,g,2848
2849,1822,221026,1515,0,3315,227678,221026,c,2849
2850,2577,220946,1485,0,2487,227495,220946,c,2850
2851,1713,220699,2590,0,1969,226971,220699,c,2851
2852,3199,206016,4821,0,1925,215961,206016,c,2852
2853,197999,1762,3587,0,2366,205714,197999,a,2853
2854,196829,1225,3507,0,11126,212687,196829,a,2854
2855,4576,206426,2470,0,3204,216676,206426,c,2855
2856,205292,3436,3358,0,4039,216125,205292,a,2856
2857,1864,205816,6994,0,1665,216339,205816,c,2857
2858,207635,2160,5472,0,1010,216277,207635,a,2858
2859,208353,1233,4345,0,1633,215564,208353,a,2859
2860,209241,1451,2754,0,2988,216434,209241,a,2860
2861,5223,205814,2705,0,1981,215723,205814,c,2861
2862,209845,2152,954,0,699,213650,209845,a,2862
2863,1725,752,210044,0,759,213280,210044,g,2863
2864,207574,3083,1247,0,3152,215056,207574,a,2864
2865,1265,836,210725,0,5433,218259,210725,g,2865
2866,3318,205518,1205,0,6229,216270,205518,c,2866
2867,914,741,7316,0,207786,216757,207786,t,2867
2868,852,2892,1486,0,212313,217543,212313,t,2868
2869,3902,2326,210424,0,1165,217817,210424,g,2869
2870,931,382,213714,0,1300,216327,213714,g,2870
2871,208848,1600,1330,0,4025,215803,208848,a,2871
2872,206387,1377,3427,0,4987,216178,206387,a,2872
2873,2502,3218,2719,0,207224,215663,207224,t,2873
2874,2289,664,1817,0,210818,215588,210818,t,2874
2875,1554,209673,2507,0,1435,215169,209673,c,2875
2876,741,800,212570,0,2911,217022,212570,g,2876
2877,1683,208507,4529,0,3822,218541,208507,c,2877
2878,1589,1330,2604,0,213680,219203,213680,t,2878
2879,1403,428,215923,0,1754,219508,215923,g,2879
2880,1916,384,215238,0,926,218464,215238,g,2880
2881,210884,1586,1861,0,3638,217969,210884,a,2881
2882,212558,3231,988,0,2336,219113,212558,a,2882
2883,1177,598,215904,0,1962,219641,215904,g,2883
2884,1556,1609,2943,0,213666,219774,213666,t,2884
2885,1084,1019,3120,0,216080,221303,216080,t,2885
2886,2095,543,218037,0,1466,222141,218037,g,2886
2887,218541,1336,667,0,1531,222075,218541,a,2887
2888,219042,1327,1012,0,719,222100,219042,a,2888
2889,1675,480,218496,0,567,221218,218496,g,2889
2890,214271,1520,567,0,1848,218206,214271,a,2890
2891,1629,210470,3913,0,2710,218722,210470,c,2891
2892,1601,1196,1363,0,214180,218340,214180,t,2892
2893,211680,1466,2726,0,2908,218780,211680,a,2893
2894,1229,1111,2087,0,214830,219257,214830,t,2894
2895,2806,1075,213753,0,1035,218669,213753,g,2895
2896,822,410,216231,0,3569,221032,216231,g,2896
2897,3005,214687,1312,0,3093,222097,214687,c,2897
2898,1365,794,1872,0,218083,222114,218083,t,2898
2899,860,1340,989,0,218555,221744,218555,t,2899
2900,1142,1063,1122,0,219216,222543,219216,t,2900
2901,787,1248,219629,0,690,222354,219629,g,2901
2902,671,579,218789,0,690,220729,218789,g,2902
2903,215174,1466,1431,0,1626,219697,215174,a,2903
2904,742,272,217231,0,1421,219666,217231,g,2904
2905,2987,726,1259,0,211194,216166,211194,t,2905
2906,209699,1019,2647,0,3843,217208,209699,a,2906
2907,1610,761,1373,0,213942,217686,213942,t,2907
2908,1200,596,1200,0,215259,218255,215259,t,2908
2909,1623,212922,2313,0,1373,218231,212922,c,2909
2910,202841,2380,1605,0,1160,207986,202841,a,2910
2911,3088,198613,3891,0,5596,211188,198613,c,2911
2912,4285,196125,3778,0,1310,205498,196125,c,2912
2913,194929,1540,1996,0,4747,203212,194929,a,2913
2914,1342,195644,3491,0,3755,204232,195644,c,2914
2915,2235,195973,4423,0,978,203609,195973,c,2915
2916,197259,1489,3553,0,781,203082,197259,a,2916
2917,196383,1256,2823,0,2596,203058,196383,a,2917
2918,1751,870,3046,0,196723,202390,196723,t,2918
2919,194777,980,4041,0,2384,202182,194777,a,2919
2920,1101,472,2353,0,197252,201178,197252,t,2920
2921,193285,1133,2025,0,2190,198633,193285,a,2921
2922,623,622,4469,0,192900,198614,192900,t,2922
2923,1390,1048,194047,0,3268,199753,194047,g,2923
2924,829,493,194790,0,5444,201556,194790,g,2924
2925,3840,193916,2271,0,3132,203159,193916,c,2925
2926,4542,572,2006,0,190104,197224,190104,t,2926
2927,192462,984,2076,0,1668,197190,192462,a,2927
2928,190135,1035,4864,0,1175,197209,190135,a,2928
2929,192449,1923,1416,0,3818,199606,192449,a,2929
2930,393,589,197843,0,1909,200734,197843,g,2930
2931,1832,991,1354,0,196829,201006,196829,t,2931
2932,1023,841,5030,0,194730,201624,194730,t,2932
2933,905,958,195935,0,4139,201937,195935,g,2933
2934,196892,1633,1346,0,2562,202433,196892,a,2934
2935,1040,567,200002,0,2264,203873,200002,g,2935
2936,192376,1461,2059,0,2912,198808,192376,a,2936
2937,980,708,195065,0,2347,199100,195065,g,2937
2938,193014,2270,1765,0,2119,199168,193014,a,2938
2939,193226,1187,1369,0,3555,199337,193226,a,2939
2940,192016,2491,3081,0,2456,200044,192016,a,2940
2941,193822,1096,3007,0,4420,202345,193822,a,2941
2942,1044,337,200391,0,1782,203554,200391,g,2942
2943,2972,195525,1622,0,2610,202729,195525,c,2943
2944,197246,1290,2248,0,2694,203478,197246,a,2944
2945,1392,699,198677,0,2754,203522,198677,g,2945
2946,1973,784,197815,0,2151,202723,197815,g,2946
2947,195464,1717,2796,0,2814,202791,195464,a,2947
2948,1033,1307,1343,0,199775,203458,199775,t,2948
2949,933,844,199498,0,2628,203903,199498,g,2949
2950,1401,537,1262,0,200758,203958,200758,t,2950
2951,197372,1737,1435,0,3235,203779,197372,a,2951
2952,970,675,2345,0,199574,203564,199574,t,2952
2953,735,643,1252,0,205120,207750,205120,t,2953
2954,1147,203981,2255,0,3413,210796,203981,c,2954
2955,1256,719,1973,0,207389,211337,207389,t,2955
2956,1087,863,208127,0,1069,211146,208127,g,2956
2957,1744,206160,1746,0,1314,210964,206160,c,2957
2958,859,378,208728,0,896,210861,208728,g,2958
2959,206630,1324,1125,0,2180,211259,206630,a,2959
2960,1798,206171,1569,0,2004,211542,206171,c,2960
2961,877,448,643,0,211038,213006,211038,t,2961
2962,2565,208576,1617,0,1542,214300,208576,c,2962
2963,211357,1168,736,0,922,214183,211357,a,2963
2964,210515,750,1267,0,1809,214341,210515,a,2964
2965,211668,1217,1081,0,865,214831,211668,a,2965
2966,211092,1517,842,0,5508,218959,211092,a,2966
2967,1376,216906,769,0,1525,220576,216906,c,2967
2968,861,365,519,0,218651,220396,218651,t,2968
2969,1810,216957,828,0,918,220513,216957,c,2969
2970,217426,1010,762,0,1181,220379,217426,a,2970
2971,544,206,974,0,219585,221309,219585,t,2971
2972,625,413,218910,0,1639,221587,218910,g,2972
2973,686,613,448,0,220081,221828,220081,t,2973
2974,1675,218840,786,0,1242,222543,218840,c,2974
2975,218471,1309,1049,0,864,221693,218471,a,2975
2976,589,257,219747,0,1549,222142,219747,g,2976
2977,1853,215901,946,0,1133,219833,215901,c,2977
2978,769,442,214974,0,865,217050,214974,g,2978
2979,1240,358,211898,0,980,214476,211898,g,2979
2980,1858,208610,637,0,1828,212933,208610,c,2980
2981,2106,208210,654,0,930,211900,208210,c,2981
2982,206408,974,1965,0,1293,210640,206408,a,2982
2983,830,256,1107,0,208660,210853,208660,t,2983
2984,208133,1017,1027,0,812,210989,208133,a,2984
2985,208072,1200,597,0,1454,211323,208072,a,2985
2986,208638,1163,1007,0,5324,216132,208638,a,2986
2987,215478,1021,1016,0,1577,219092,215478,a,2987
2988,1748,471,216718,0,691,219628,216718,g,2988
2989,212119,1469,1106,0,3344,218038,212119,a,2989
2990,2725,213153,2626,0,2575,221079,213153,c,2990
2991,216085,1074,529,0,1082,218770,216085,a,2991
2992,214673,745,1114,0,4498,221030,214673,a,2992
2993,3331,215630,1850,0,1059,221870,215630,c,2993
2994,213493,2094,654,0,1223,217464,213493,a,2994
2995,1559,335,215314,0,485,217693,215314,g,2995
2996,211067,2203,1848,0,2679,217797,211067,a,2996
2997,2048,655,213089,0,2324,218116,213089,g,2997
2998,2768,206961,764,0,2629,213122,206961,c,2998
2999,2104,206361,3144,0,1025,212634,206361,c,2999
3000,1514,531,209362,0,772,212179,209362,g,3000
3001,2650,780,1254,0,203611,208295,203611,t,3001
3002,3242,201459,3142,0,994,208837,201459,c,3002
3003,2939,199282,2725,0,2709,207655,199282,c,3003
3004,202946,1530,1706,0,1143,207325,202946,a,3004
3005,1797,1349,2689,0,203198,209033,203198,t,3005
3006,1408,501,206894,0,2329,211132,206894,g,3006
3007,2066,204064,1776,0,4079,211985,204064,c,3007
3008,4511,205299,1163,0,530,211503,205299,c,3008
3009,1303,463,208816,0,283,210865,208816,g,3009
3010,204906,2057,1345,0,1895,210203,204906,a,3010
3011,2655,619,2825,0,203230,209329,203230,t,3011
3012,202770,3569,950,0,1841,209130,202770,a,3012
3013,2504,402,2040,0,204254,209200,204254,t,3013
3014,1407,2021,204838,0,1253,209519,204838,g,3014
3015,512,927,207538,0,825,209802,207538,g,3015
3016,541,838,207394,0,515,209288,207394,g,3016
3017,3375,781,2007,0,201236,207399,201236,t,3017
3018,1885,547,2251,0,204347,209030,204347,t,3018
3019,205484,2091,1379,0,933,209887,205484,a,3019
3020,1035,281,2455,0,206647,210418,206647,t,3020
3021,1705,1378,939,0,209265,213287,209265,t,3021
3022,506,260,212884,0,1372,215022,212884,g,3022
3023,495,441,211826,0,2657,215419,211826,g,3023
3024,211343,1880,1838,0,651,215712,211343,a,3024
3025,2225,297,1388,0,212520,216430,212520,t,3025
3026,214746,1173,1034,0,505,217458,214746,a,3026
3027,2393,277,214370,0,393,217433,214370,g,3027
3028,214825,1172,701,0,270,216968,214825,a,3028
3029,213626,975,1395,0,1305,217301,213626,a,3029
3030,214461,1678,376,0,2044,218559,214461,a,3030
3031,3583,483,213392,0,795,218253,213392,g,3031
3032,4665,1252,2010,0,209239,217166,209239,t,3032
3033,1053,390,213639,0,727,215809,213639,g,3033
3034,2854,209593,987,0,960,214394,209593,c,3034
3035,202802,1475,1268,0,2106,207651,202802,a,3035
3036,3890,200158,1600,0,686,206334,200158,c,3036
3037,1919,685,1753,0,199676,204033,199676,t,3037
3038,1815,199406,2420,0,1125,204766,199406,c,3038
3039,200231,1890,1329,0,611,204061,200231,a,3039
3040,199086,1105,2321,0,1215,203727,199086,a,3040
3041,2310,1467,1954,0,198154,203885,198154,t,3041
3042,1491,450,198744,0,521,201206,198744,g,3042
3043,194878,2123,2341,0,1186,200528,194878,a,3043
3044,3652,193994,2203,0,508,200357,193994,c,3044
3045,186155,2085,1544,0,1859,191643,186155,a,3045
3046,2035,181199,5528,0,1157,189919,181199,c,3046
3047,177221,2527,2576,0,854,183178,177221,a,3047
3048,994,2179,2874,0,180902,186949,180902,t,3048
3049,743,1583,185610,0,1062,188998,185610,g,3049
3050,458,242,185775,0,1996,188471,185775,g,3050
3051,181956,2031,1271,0,1931,187189,181956,a,3051
3052,183304,1806,1511,0,823,187444,183304,a,3052
3053,2101,295,184210,0,842,187448,184210,g,3053
3054,181800,1306,1390,0,885,185381,181800,a,3054
3055,1419,319,2135,0,179826,183699,179826,t,3055
3056,180044,2796,452,0,3215,186507,180044,a,3056
3057,936,283,185867,0,1744,188830,185867,g,3057
3058,179255,1369,5543,0,4187,190354,179255,a,3058
3059,1591,413,189062,0,1776,192842,189062,g,3059
3060,187984,781,1131,0,2120,192016,187984,a,3060
3061,188138,745,1887,0,921,191691,188138,a,3061
3062,188501,767,1330,0,5146,195744,188501,a,3062
3063,2454,298,194274,0,1965,198991,194274,g,3063
3064,4793,190693,886,0,2532,198904,190693,c,3064
3065,2035,189506,4908,0,380,196829,189506,c,3065
3066,600,305,1041,0,196724,198670,196724,t,3066
3067,1612,195058,2169,0,773,199612,195058,c,3067
3068,690,420,4285,0,193868,199263,193868,t,3068
3069,1983,460,2353,0,193916,198712,193916,t,3069
3070,1287,173,2662,0,194304,198426,194304,t,3070
3071,1745,192027,2248,0,2351,198371,192027,c,3071
3072,193665,1330,1879,0,764,197638,193665,a,3072
3073,531,681,1945,0,197018,200175,197018,t,3073
3074,1129,197594,2007,0,769,201499,197594,c,3074
3075,439,389,199786,0,559,201173,199786,g,3075
3076,196358,2268,1028,0,730,200384,196358,a,3076
3077,196099,2125,910,0,2562,201696,196099,a,3077
3078,985,332,200205,0,758,202280,200205,g,3078
3079,1062,339,1418,0,198601,201420,198601,t,3079
3080,721,311,1864,0,198659,201555,198659,t,3080
3081,198879,794,436,0,1608,201717,198879,a,3081
3082,199846,878,718,0,356,201798,199846,a,3082
3083,198608,960,1293,0,1117,201978,198608,a,3083
3084,200417,938,394,0,482,202231,200417,a,3084
3085,2443,901,197181,0,3631,204156,197181,g,3085
3086,1823,201618,519,0,787,204747,201618,c,3086
3087,664,453,695,0,202876,204688,202876,t,3087
3088,664,694,202199,0,1290,204847,202199,g,3088
3089,1546,200638,570,0,1379,204133,200638,c,3089
3090,2656,193972,1302,0,553,198483,193972,c,3090
3091,191099,1259,1926,0,1289,195573,191099,a,3091
3092,2796,190664,1340,0,776,195576,190664,c,3092
3093,765,773,859,0,193503,195900,193503,t,3093
3094,1062,1509,192682,0,4880,200133,192682,g,3094
3095,1172,300,199326,0,1524,202322,199326,g,3095
3096,2581,194229,1989,0,1852,200651,194229,c,3096
3097,3094,191884,2058,0,404,197440,191884,c,3097
3098,193941,1063,1108,0,627,196739,193941,a,3098
3099,192576,965,2511,0,1481,197533,192576,a,3099
3100,194773,2149,385,0,4598,201905,194773,a,3100
3101,1082,469,200372,0,997,202920,200372,g,3101
3102,2128,1658,1669,0,200625,206080,200625,t,3102
3103,2679,202282,2160,0,770,207891,202282,c,3103
3104,203215,1317,2105,0,3817,210454,203215,a,3104
3105,3421,205373,1591,0,1216,211601,205373,c,3105
3106,195897,1331,1343,0,782,199353,195897,a,3106
3107,2299,189705,5855,0,1034,198893,189705,c,3107
3108,193079,1872,1574,0,665,197190,193079,a,3108
3109,2150,186520,3434,0,3854,195958,186520,c,3109
3110,1561,192141,1163,0,2588,197453,192141,c,3110
3111,1641,188994,6428,0,800,197863,188994,c,3111
3112,1348,779,2392,0,190700,195219,190700,t,3112
3113,3135,188891,1810,0,1340,195176,188891,c,3113
3114,2380,810,1586,0,189601,194377,189601,t,3114
3115,1815,486,190767,0,695,193763,190767,g,3115
3116,831,355,186950,0,2721,190857,186950,g,3116
3117,184347,3797,1507,0,1365,191016,184347,a,3117
3118,2048,287,188329,0,705,191369,188329,g,3118
3119,2723,901,4977,0,181526,190127,181526,t,3119
3120,183610,2965,2916,0,1191,190682,183610,a,3120
3121,184604,1360,4108,0,1090,191162,184604,a,3121
3122,3120,2084,1562,0,184990,191756,184990,t,3122
3123,3727,537,186317,0,834,191415,186317,g,3123
3124,978,310,184130,0,3613,189031,184130,g,3124
3125,182441,3956,855,0,1061,188313,182441,a,3125
3126,817,288,186400,0,901,188406,186400,g,3126
3127,1897,1438,2467,0,181746,187548,181746,t,3127
3128,510,411,186764,0,996,188681,186764,g,3128
3129,2910,720,1370,0,183116,188116,183116,t,3129
3130,3593,770,1050,0,184853,190266,184853,t,3130
3131,185584,1864,2373,0,1185,191006,185584,a,3131
3132,1196,344,188361,0,791,190692,188361,g,3132
3133,185736,1223,2150,0,876,189985,185736,a,3133
3134,184250,1371,2395,0,1853,189869,184250,a,3134
3135,184212,2243,1462,0,4136,192053,184212,a,3135
3136,803,427,190376,0,1823,193429,190376,g,3136
3137,4160,1555,1496,0,184482,191693,184482,t,3137
3138,780,806,188872,0,651,191109,188872,g,3138
3139,183711,1618,1837,0,2087,189253,183711,a,3139
3140,821,419,186134,0,918,188292,186134,g,3140
3141,178144,1587,1070,0,2737,183538,178144,a,3141
3142,2219,957,1360,0,179707,184243,179707,t,3142
3143,540,1509,182932,0,1032,186013,182932,g,3143
3144,181172,838,2269,0,1467,185746,181172,a,3144
3145,1485,730,1972,0,181449,185636,181449,t,3145
3146,180489,1967,1825,0,1687,185968,180489,a,3146
3147,181512,918,2100,0,1583,186113,181512,a,3147
3148,961,1023,2641,0,181341,185966,181341,t,3148
3149,1105,710,1427,0,183011,186253,183011,t,3149
3150,983,182052,2441,0,5367,190843,182052,c,3150
3151,1282,187757,2340,0,4409,195788,187757,c,3151
3152,193749,1087,1129,0,1274,197239,193749,a,3152
3153,194530,1146,1211,0,897,197784,194530,a,3153
3154,194662,1222,744,0,1160,197788,194662,a,3154
3155,596,214,196707,0,422,197939,196707,g,3155
3156,195293,1008,600,0,1043,197944,195293,a,3156
3157,194901,1193,1109,0,1108,198311,194901,a,3157
3158,541,327,790,0,196550,198208,196550,t,3158
3159,491,1336,1074,0,195228,198129,195228,t,3159
3160,329,368,651,0,198239,199587,198239,t,3160
3161,1547,197375,712,0,1156,200790,197375,c,3161
3162,462,303,199166,0,1315,201246,199166,g,3162
3163,1220,197594,1481,0,856,201151,197594,c,3163
3164,478,535,666,0,198825,200504,198825,t,3164
3165,449,450,198473,0,1031,200403,198473,g,3165
3166,566,234,198055,0,859,199714,198055,g,3166
3167,196209,706,529,0,1446,198890,196209,a,3167
3168,1522,196041,499,0,923,198985,196041,c,3168
3169,1163,195323,1274,0,996,198756,195323,c,3169
3170,196362,1012,697,0,704,198775,196362,a,3170
3171,626,342,197071,0,842,198881,197071,g,3171
3172,979,745,512,0,197954,200190,197954,t,3172
3173,387,321,199807,0,1051,201566,199807,g,3173
3174,476,234,619,0,203675,205004,203675,t,3174
3175,1264,204879,249,0,549,206941,204879,c,3175
3176,203907,1691,895,0,1026,207519,203907,a,3176
3177,1248,204613,894,0,1513,208268,204613,c,3177
3178,205822,806,904,0,399,207931,205822,a,3178
3179,206135,751,415,0,6689,213990,206135,a,3179
3180,1780,214394,589,0,548,217311,214394,c,3180
3181,213935,1265,409,0,3878,219487,213935,a,3181
3182,1421,217789,1389,0,478,221077,217789,c,3182
3183,218167,1040,1046,0,371,220624,218167,a,3183
3184,218331,720,520,0,1903,221474,218331,a,3184
3185,1684,218949,991,0,865,222489,218949,c,3185
3186,1429,387,729,0,217726,220271,217726,t,3186
3187,215970,550,923,0,1591,219034,215970,a,3187
3188,1851,215837,500,0,670,218858,215837,c,3188
3189,216059,949,818,0,853,218679,216059,a,3189
3190,1114,207,215595,0,368,217284,215595,g,3190
3191,212276,742,403,0,891,214312,212276,a,3191
3192,2100,210133,836,0,2007,215076,210133,c,3192
3193,1798,208007,1607,0,810,212222,208007,c,3193
3194,208967,791,950,0,2796,213504,208967,a,3194
3195,763,403,212727,0,730,214623,212727,g,3195
3196,1520,1199,202596,0,3264,208579,202596,g,3196
3197,2399,202504,2154,0,1784,208841,202504,c,3197
3198,1648,611,1510,0,203051,206820,203051,t,3198
3199,201505,2478,552,0,1973,206508,201505,a,3199
3200,1421,201060,2871,0,4293,209645,201060,c,3200
3201,1282,205789,1759,0,3496,212326,205789,c,3201
3202,207876,713,3295,0,1956,213840,207876,a,3202
3203,1371,320,884,0,212337,214912,212337,t,3203
3204,212070,1027,870,0,6345,220312,212070,a,3204
3205,1702,218524,3108,0,1297,224631,218524,c,3205
3206,218378,1582,2867,0,2411,225238,218378,a,3206
3207,1194,220815,3384,0,956,226349,220815,c,3207
3208,222851,1018,1309,0,721,225899,222851,a,3208
3209,222868,1127,1096,0,928,226019,222868,a,3209
3210,223163,1448,502,0,1466,226579,223163,a,3210
3211,1636,221315,3171,0,1508,227630,221315,c,3211
3212,220006,1304,609,0,1899,223818,220006,a,3212
3213,1082,344,221080,0,1188,223694,221080,g,3213
3214,1771,217627,1656,0,2513,223567,217627,c,3214
3215,216099,2000,2183,0,1206,221488,216099,a,3215
3216,2122,509,216386,0,1130,220147,216386,g,3216
3217,2338,529,212118,0,800,215785,212118,g,3217
3218,210131,1430,1120,0,1840,214521,210131,a,3218
3219,3420,205035,2314,0,2743,213512,205035,c,3219
3220,3219,204518,2550,0,2136,212423,204518,c,3220
3221,206860,1341,2340,0,2061,212602,206860,a,3221
3222,1091,2359,3087,0,206464,213001,206464,t,3222
3223,2456,1209,208931,0,1034,213630,208931,g,3223
3224,1299,445,207201,0,5967,214912,207201,g,3224
3225,1658,208439,1923,0,3139,215159,208439,c,3225
3226,206146,1530,5403,0,1679,214758,206146,a,3226
3227,1109,367,1596,0,212130,215202,212130,t,3227
3228,2800,206747,3497,0,2105,215149,206747,c,3228
3229,1193,803,1363,0,211534,214893,211534,t,3229
3230,209458,3151,888,0,1307,214804,209458,a,3230
3231,558,639,212717,0,2805,216719,212717,g,3231
3232,997,291,213051,0,1032,215371,213051,g,3232
3233,6693,1732,3850,0,201121,213396,201121,t,3233
3234,209437,1701,1346,0,807,213291,209437,a,3234
3235,209798,1491,1125,0,1167,213581,209798,a,3235
3236,1243,360,210129,0,4058,215790,210129,g,3236
3237,4885,208959,1973,0,940,216757,208959,c,3237
3238,796,312,5051,0,210160,216319,210160,t,3238
3239,2227,1486,1167,0,211232,216112,211232,t,3239
3240,940,595,213453,0,1162,216150,213453,g,3240
3241,209502,2336,2087,0,2328,216253,209502,a,3241
3242,1078,370,214221,0,849,216518,214221,g,3242
3243,209052,1969,1047,0,5035,217103,209052,a,3243
3244,2897,940,1689,0,214291,219817,214291,t,3244
3245,2357,1969,214600,0,879,219805,214600,g,3245
3246,1021,565,216785,0,1372,219743,216785,g,3246
3247,212847,2428,1341,0,10279,226895,212847,a,3247
3248,2353,223573,3338,0,2423,231687,223573,c,3248
3249,1394,523,3060,0,222501,227478,222501,t,3249
3250,943,1355,1787,0,223212,227297,223212,t,3250
3251,1960,1560,1903,0,221990,227413,221990,t,3251
3252,727,372,225614,0,1044,227757,225614,g,3252
3253,224297,1127,860,0,889,227173,224297,a,3253
3254,992,716,1668,0,223218,226594,223218,t,3254
3255,893,1610,1206,0,222596,226305,222596,t,3255
3256,780,434,1024,0,224419,226657,224419,t,3256
3257,1254,222750,852,0,1326,226182,222750,c,3257
3258,850,702,1971,0,222435,225958,222435,t,3258
3259,336,335,223895,0,1029,225595,223895,g,3259
3260,1516,219554,1091,0,1500,223661,219554,c,3260
3261,564,222,220937,0,692,222415,220937,g,3261
3262,217829,1305,738,0,1079,220951,217829,a,3262
3263,216102,1467,1050,0,1809,220428,216102,a,3263
3264,811,1199,217563,0,1191,220764,217563,g,3264
3265,453,237,218733,0,569,219992,218733,g,3265
3266,216296,1238,1596,0,592,219722,216296,a,3266
3267,215794,1516,632,0,3634,221576,215794,a,3267
3268,2036,218677,865,0,2306,223884,218677,c,3268
3269,2012,217597,2137,0,812,222558,217597,c,3269
3270,218848,934,1292,0,2154,223228,218848,a,3270
3271,1687,219103,2458,0,632,223880,219103,c,3271
3272,218645,2444,607,0,2190,223886,218645,a,3272
3273,498,267,223046,0,791,224602,223046,g,3273
3274,2276,1160,735,0,220048,224219,220048,t,3274
3275,517,1631,221230,0,2368,225746,221230,g,3275
3276,482,482,223923,0,2819,227706,223923,g,3276
3277,2180,839,1275,0,225049,229343,225049,t,3277
3278,681,1274,226809,0,1246,230010,226809,g,3278
3279,1147,255,226503,0,1618,229523,226503,g,3279
3280,2210,933,2503,0,223803,229449,223803,t,3280
3281,892,645,226875,0,937,229349,226875,g,3281
3282,225022,1315,610,0,3734,230681,225022,a,3282
3283,2631,226678,1453,0,2333,233095,226678,c,3283
3284,1655,675,2023,0,227912,232265,227912,t,3284
3285,544,273,230768,0,595,232180,230768,g,3285
3286,227468,1918,724,0,3624,233734,227468,a,3286
3287,2118,665,231364,0,582,234729,231364,g,3287
3288,886,227,230090,0,743,231946,230090,g,3288
3289,224292,1909,777,0,1343,228321,224292,a,3289
3290,1777,221163,3795,0,1626,228361,221163,c,3290
3291,1367,996,881,0,226482,229726,226482,t,3291
3292,753,458,228606,0,3821,233638,228606,g,3292
3293,1104,1014,1253,0,231539,234910,231539,t,3293
3294,1366,861,231770,0,712,234709,231770,g,3294
3295,640,206,230838,0,960,232644,230838,g,3295
3296,226492,1395,1113,0,1011,230011,226492,a,3296
3297,225747,1392,1359,0,1351,229849,225747,a,3297
3298,225406,2090,592,0,1072,229160,225406,a,3298
3299,452,522,2351,0,227288,230613,227288,t,3299
3300,225127,1892,1107,0,1010,229136,225127,a,3300
3301,428,216,226366,0,829,227839,226366,g,3301
3302,222172,1718,823,0,2864,227577,222172,a,3302
3303,1905,341,222715,0,1110,226071,222715,g,3303
3304,696,251,218294,0,1699,220940,218294,g,3304
3305,216459,1176,519,0,1558,219712,216459,a,3305
3306,1958,213478,3482,0,1295,220213,213478,c,3306
3307,2432,213878,810,0,1980,219100,213878,c,3307
3308,1430,213532,3760,0,648,219370,213532,c,3308
3309,672,559,668,0,218182,220081,218182,t,3309
3310,1173,218178,439,0,2637,222427,218178,c,3310
3311,386,442,2891,0,219728,223447,219728,t,3311
3312,343,206,2083,0,220998,223630,220998,t,3312
3313,535,254,1872,0,220860,223521,220860,t,3313
3314,219955,1067,647,0,2080,223749,219955,a,3314
3315,220645,1059,1850,0,891,224445,220645,a,3315
3316,350,165,223674,0,946,225135,223674,g,3316
3317,220391,1231,1478,0,412,223512,220391,a,3317
3318,220649,901,1080,0,2015,224645,220649,a,3318
3319,2914,220571,1304,0,546,225335,220571,c,3319
3320,221673,1281,1196,0,296,224446,221673,a,3320
3321,220704,987,1447,0,1479,224617,220704,a,3321
3322,1854,220512,1794,0,636,224796,220512,c,3322
3323,1058,320,1250,0,220596,223224,220596,t,3323
3324,219409,1031,1480,0,1362,223282,219409,a,3324
3325,1415,219267,1657,0,1146,223485,219267,c,3325
3326,1522,303,738,0,220627,223190,220627,t,3326
3327,852,358,221067,0,900,223177,221067,g,3327
3328,1481,218905,696,0,1611,222693,218905,c,3328
3329,1853,218835,1190,0,361,222239,218835,c,3329
3330,519,411,619,0,219739,221288,219739,t,3330
3331,1189,219428,634,0,1415,222666,219428,c,3331
3332,335,381,1328,0,227050,229094,227050,t,3332
3333,299,339,230566,0,1501,232705,230566,g,3333
3334,638,210,231447,0,1314,233609,231447,g,3334
3335,230566,1258,822,0,712,233358,230566,a,3335
3336,230014,1534,857,0,397,232802,230014,a,3336
3337,230400,1008,878,0,224,232510,230400,a,3337
3338,230023,972,914,0,2042,233951,230023,a,3338
3339,1788,231813,695,0,542,234838,231813,c,3339
3340,731,237,833,0,229918,231719,229918,t,3340
3341,1344,229073,818,0,834,232069,229073,c,3341
3342,228576,882,1913,0,412,231783,228576,a,3342
3343,421,289,1492,0,232242,234444,232242,t,3343
3344,233861,838,479,0,1702,236880,233861,a,3344
3345,235472,719,429,0,2904,239524,235472,a,3345
3346,2005,236781,1554,0,572,240912,236781,c,3346
3347,238651,1119,529,0,914,241213,238651,a,3347
3348,554,311,240380,0,448,241693,240380,g,3348
3349,238355,2191,311,0,301,241158,238355,a,3349
3350,237358,1660,1518,0,515,241051,237358,a,3350
3351,738,416,525,0,238346,240025,238346,t,3351
3352,710,1257,236664,0,1007,239638,236664,g,3352
3353,454,251,238445,0,735,239885,238445,g,3353
3354,1926,676,735,0,237133,240470,237133,t,3354
3355,490,384,239070,0,1869,241813,239070,g,3355
3356,1624,236912,836,0,1796,241168,236912,c,3356
3357,1150,274,712,0,240495,242631,240495,t,3357
3358,422,380,242014,0,785,243601,242014,g,3358
3359,1825,239266,630,0,2466,244187,239266,c,3359
3360,2650,240988,559,0,334,244531,240988,c,3360
3361,594,252,240276,0,433,241555,240276,g,3361
3362,237926,1798,632,0,614,240970,237926,a,3362
3363,1100,613,698,0,240125,242536,240125,t,3363
3364,1813,239126,424,0,770,242133,239126,c,3364
3365,639,291,1628,0,240834,243392,240834,t,3365
3366,840,818,395,0,242293,244346,242293,t,3366
3367,639,424,242188,0,2053,245304,242188,g,3367
3368,1466,241538,902,0,1160,245066,241538,c,3368
3369,237386,1542,1297,0,1715,241940,237386,a,3369
3370,1261,236360,3718,0,1459,242798,236360,c,3370
3371,236182,1582,854,0,448,239066,236182,a,3371
3372,1863,210,1561,0,235405,239039,235405,t,3372
3373,1235,1653,3049,0,232537,238474,232537,t,3373
3374,234144,1145,1648,0,1476,238413,234144,a,3374
3375,1826,230501,3815,0,1884,238026,230501,c,3375
3376,2820,228356,2042,0,437,233655,228356,c,3376
3377,226516,1305,4433,0,1044,233298,226516,a,3377
3378,2462,222082,1423,0,8323,234290,222082,c,3378
3379,4834,223325,778,0,958,229895,223325,c,3379
3380,685,660,224918,0,2401,228664,224918,g,3380
3381,3854,219311,1311,0,3881,228357,219311,c,3381
3382,1131,556,4366,0,221737,227790,221737,t,3382
3383,220367,3010,623,0,3485,227485,220367,a,3383
3384,222818,1592,2810,0,379,227599,222818,a,3384
3385,914,249,225637,0,431,227231,225637,g,3385
3386,220470,1605,3859,0,614,226548,220470,a,3386
3387,1334,323,4313,0,219070,225040,219070,t,3387
3388,223205,1626,775,0,2224,227830,223205,a,3388
3389,5065,218923,3362,0,1069,228419,218923,c,3389
3390,224507,1691,638,0,1241,228077,224507,a,3390
3391,1014,739,225501,0,503,227757,225501,g,3391
3392,220145,3611,1084,0,1287,226127,220145,a,3392
3393,1002,647,222496,0,4231,228376,222496,g,3393
3394,1021,392,224874,0,5747,232034,224874,g,3394
3395,3028,2470,2953,0,224822,233273,224822,t,3395
3396,1339,516,229701,0,2607,234163,229701,g,3396
3397,227313,1734,1281,0,4148,234476,227313,a,3397
3398,1415,218,232134,0,3200,236967,232134,g,3398
3399,1800,987,230093,0,1795,234675,230093,g,3399
3400,226743,1852,777,0,3235,232607,226743,a,3400
3401,2323,226630,1750,0,1838,232541,226630,c,3401
3402,1989,618,226461,0,972,230040,226461,g,3402
3403,536,297,227940,0,563,229336,227940,g,3403
3404,222860,1986,1542,0,1114,227502,222860,a,3404
3405,3559,731,1345,0,219129,224764,219129,t,3405
3406,927,451,221124,0,1503,224005,221124,g,3406
3407,2886,217579,1168,0,1319,222952,217579,c,3407
3408,1082,906,2876,0,217853,222717,217853,t,3408
3409,712,2091,217671,0,1742,222216,217671,g,3409
3410,866,280,218645,0,481,220272,218645,g,3410
3411,2454,938,2008,0,208219,213619,208219,t,3411
3412,208039,2324,751,0,1717,212831,208039,a,3412
3413,1610,206438,2515,0,1794,212357,206438,c,3413
3414,1154,1276,206536,0,1708,210674,206536,g,3414
3415,1262,575,206066,0,1152,209055,206066,g,3415
3416,1704,579,203735,0,1883,207901,203735,g,3416
3417,194393,1980,1323,0,4901,202597,194393,a,3417
3418,2602,2931,3017,0,197753,206303,197753,t,3418
3419,1755,1673,200570,0,413,204411,200570,g,3419
3420,1532,407,200997,0,1452,204388,200997,g,3420
3421,198150,1596,2640,0,1104,203490,198150,a,3421
3422,197131,2436,2712,0,918,203197,197131,a,3422
3423,196851,1355,3067,0,705,201978,196851,a,3423
3424,2292,370,3405,0,195605,201672,195605,t,3424
3425,2157,194613,1933,0,2862,201565,194613,c,3425
3426,196205,2280,1469,0,1799,201753,196205,a,3426
3427,558,605,200800,0,508,202471,200800,g,3427
3428,191734,1155,1002,0,3136,197027,191734,a,3428
3429,1332,188290,4072,0,2408,196102,188290,c,3429
3430,1660,187735,3194,0,2932,195521,187735,c,3430
3431,189631,1114,2998,0,1632,195375,189631,a,3431
3432,307,783,3263,0,190858,195211,190858,t,3432
3433,543,3810,2962,0,188521,195836,188521,t,3433
3434,408,206,194546,0,772,195932,194546,g,3434
3435,188683,1292,3399,0,1751,195125,188683,a,3435
3436,190867,1190,1188,0,1790,195035,190867,a,3436
3437,191445,1362,1106,0,549,194462,191445,a,3437
3438,504,156,192978,0,608,194246,192978,g,3438
3439,188717,1550,1949,0,861,193077,188717,a,3439
3440,684,259,192074,0,774,193791,192074,g,3440
3441,186468,2224,1294,0,1481,191467,186468,a,3441
3442,185380,1213,3147,0,1041,190781,185380,a,3442
3443,185451,1177,979,0,1877,189484,185451,a,3443
3444,684,511,186421,0,629,188245,186421,g,3444
3445,182479,1123,912,0,1956,186470,182479,a,3445
3446,182455,1021,1897,0,5542,190915,182455,a,3446
3447,995,449,190308,0,1905,193657,190308,g,3447
3448,185378,1016,1458,0,1206,189058,185378,a,3448
3449,385,219,187912,0,1228,189744,187912,g,3449
3450,186099,2085,393,0,4297,192874,186099,a,3450
3451,190981,673,1985,0,1773,195412,190981,a,3451
3452,1456,1477,886,0,191404,195223,191404,t,3452
3453,763,770,1818,0,191974,195325,191974,t,3453
3454,1645,1368,1112,0,192401,196526,192401,t,3454
3455,713,472,195031,0,2797,199013,195031,g,3455
3456,884,182,197715,0,996,199777,197715,g,3456
3457,1663,374,1663,0,195300,199000,195300,t,3457
3458,2163,193800,2439,0,655,199057,193800,c,3458
3459,196396,560,1516,0,507,198979,196396,a,3459
3460,195064,755,903,0,2445,199167,195064,a,3460
3461,1448,196050,1415,0,360,199273,196050,c,3461
3462,1151,221,1479,0,196837,199688,196837,t,3462
3463,1314,196509,845,0,2997,201665,196509,c,3463
3464,1386,198678,1999,0,574,202637,198678,c,3464
3465,492,190,2416,0,199366,202464,199366,t,3465
3466,782,449,519,0,200727,202477,200727,t,3466
3467,744,449,200732,0,771,202696,200732,g,3467
3468,750,235,200113,0,557,201655,200113,g,3468
3469,906,382,947,0,200266,202501,200266,t,3469
3470,1635,200747,868,0,424,203674,200747,c,3470
3471,200826,673,1162,0,1093,203754,200826,a,3471
3472,1492,200825,901,0,707,203925,200825,c,3472
3473,201215,1112,451,0,2775,205553,201215,a,3473
3474,468,188,206075,0,2255,208986,206075,g,3474
3475,1348,204994,521,0,2595,209458,204994,c,3475
3476,1728,205632,574,0,585,208519,205632,c,3476
3477,510,183,206280,0,538,207511,206280,g,3477
3478,576,242,204117,0,793,205728,204117,g,3478
3479,198071,1026,670,0,756,200523,198071,a,3479
3480,1495,195614,2222,0,1062,200393,195614,c,3480
3481,194208,808,938,0,487,196441,194208,a,3481
3482,948,466,973,0,194177,196564,194177,t,3482
3483,582,3126,191403,0,9265,204376,191403,g,3483
3484,704,390,208628,0,1253,210975,208628,g,3484
3485,1366,259,206553,0,1388,209566,206553,g,3485
3486,5012,194721,602,0,1179,201514,194721,c,3486
3487,199857,1129,680,0,923,202589,199857,a,3487
3488,567,165,201376,0,707,202815,201376,g,3488
3489,200640,1117,326,0,710,202793,200640,a,3489
3490,484,256,3169,0,199020,202929,199020,t,3490
3491,1067,3925,915,0,198463,204370,198463,t,3491
3492,451,193,203392,0,564,204600,203392,g,3492
3493,199218,853,1536,0,4726,206333,199218,a,3493
3494,2679,202489,2092,0,378,207638,202489,c,3494
3495,202688,595,2216,0,492,205991,202688,a,3495
3496,199840,791,1935,0,2386,204952,199840,a,3496
3497,1715,200058,2875,0,592,205240,200058,c,3497
3498,1066,950,1658,0,201618,205292,201618,t,3498
3499,911,901,2031,0,201496,205339,201496,t,3499
3500,491,802,1747,0,201644,204684,201644,t,3500
3501,1035,768,1815,0,200617,204235,200617,t,3501
3502,1488,198990,2431,0,757,203666,198990,c,3502
3503,198214,677,1328,0,1476,201695,198214,a,3503
3504,2130,194826,2284,0,626,199866,194826,c,3504
3505,1515,278,1338,0,187209,190340,187209,t,3505
3506,185292,3852,664,0,872,190680,185292,a,3506
3507,1454,311,188502,0,394,190661,188502,g,3507
3508,568,429,187517,0,1012,189526,187517,g,3508
3509,185595,1750,879,0,1163,189387,185595,a,3509
3510,903,396,187304,0,325,188928,187304,g,3510
3511,1566,623,597,0,185272,188058,185272,t,3511
3512,1061,182782,4213,0,829,188885,182782,c,3512
3513,1112,219,1104,0,188330,190765,188330,t,3513
3514,3301,1046,243,0,188546,193136,188546,t,3514
3515,287,1323,191069,0,1346,194025,191069,g,3515
3516,956,317,189068,0,1517,191858,189068,g,3516
3517,550,246,189005,0,984,190785,189005,g,3517
3518,185630,1297,813,0,1403,189143,185630,a,3518
3519,186491,1144,589,0,3344,191568,186491,a,3519
3520,2901,881,2509,0,188584,194875,188584,t,3520
3521,2425,739,191768,0,1309,196241,191768,g,3521
3522,875,256,193758,0,3285,198174,193758,g,3522
3523,1802,193998,730,0,2284,198814,193998,c,3523
3524,191387,853,4265,0,309,196814,191387,a,3524
3525,518,197,1675,0,194566,196956,194566,t,3525
3526,2749,2500,311,0,192628,198188,192628,t,3526
3527,383,263,197520,0,317,198483,197520,g,3527
3528,2277,604,1200,0,193952,198033,193952,t,3528
3529,502,191,2159,0,196479,199331,196479,t,3529
3530,1343,195626,369,0,4769,202107,195626,c,3530
3531,2672,196550,1342,0,1965,202529,196550,c,3531
3532,313,1142,1993,0,200071,203519,200071,t,3532
3533,279,196,201632,0,896,203003,201632,g,3533
3534,384,161,200474,0,1711,202730,200474,g,3534
3535,200101,1040,328,0,882,202351,200101,a,3535
3536,199912,859,1182,0,1527,203480,199912,a,3536
3537,1445,218,201711,0,777,204151,201711,g,3537
3538,200569,932,1896,0,1245,204642,200569,a,3538
3539,202175,1191,657,0,661,204684,202175,a,3539
3540,200953,1234,2061,0,480,204728,200953,a,3540
3541,906,283,456,0,204356,206001,204356,t,3541
3542,365,188,204623,0,4733,209909,204623,g,3542
3543,1211,208353,453,0,1110,211127,208353,c,3543
3544,731,333,527,0,211502,213093,211502,t,3544
3545,1011,209534,816,0,881,212242,209534,c,3545
3546,208296,602,1044,0,720,210662,208296,a,3546
3547,969,175,208135,0,587,209866,208135,g,3547
3548,555,250,207576,0,671,209052,207576,g,3548
3549,206027,765,744,0,1076,208612,206027,a,3549
3550,1256,205014,1217,0,1276,208763,205014,c,3550
3551,1893,202855,731,0,1812,207291,202855,c,3551
3552,1402,204670,783,0,665,207520,204670,c,3552
3553,238,321,206332,0,347,207238,206332,g,3553
3554,201709,2227,568,0,4047,208551,201709,a,3554
3555,603,264,207939,0,693,209499,207939,g,3555
3556,607,308,670,0,202768,204353,202768,t,3556
3557,200708,2322,464,0,1218,204712,200708,a,3557
3558,406,257,203232,0,4539,208434,203232,g,3558
3559,484,381,207764,0,2594,211223,207764,g,3559
3560,207890,788,899,0,1813,211390,207890,a,3560
3561,207543,523,703,0,2223,210992,207543,a,3561
3562,1564,207773,1325,0,1946,212608,207773,c,3562
3563,751,242,207278,0,424,208695,207278,g,3563
3564,203245,1280,2101,0,888,207514,203245,a,3564
3565,204777,954,1309,0,550,207590,204777,a,3565
3566,203600,888,861,0,1572,206921,203600,a,3566
3567,1205,200680,2954,0,1291,206130,200680,c,3567
3568,199804,876,1937,0,1472,204089,199804,a,3568
3569,430,808,1720,0,201897,204855,201897,t,3569
3570,352,630,202901,0,1019,204902,202901,g,3570
3571,1741,197731,2224,0,2542,204238,197731,c,3571
3572,199368,1075,1335,0,874,202652,199368,a,3572
3573,197498,1290,2034,0,710,201532,197498,a,3573
3574,1534,270,2541,0,197299,201644,197299,t,3574
3575,197051,1318,810,0,3118,202297,197051,a,3575
3576,1149,198834,1892,0,861,202736,198834,c,3576
3577,749,527,2396,0,199376,203048,199376,t,3577
3578,197840,1136,1098,0,3353,203427,197840,a,3578
3579,1593,199101,1977,0,473,203144,199101,c,3579
3580,673,143,1593,0,200360,202769,200360,t,3580
3581,199113,1260,728,0,2241,203342,199113,a,3581
3582,339,151,203146,0,438,204074,203146,g,3582
3583,910,402,1538,0,201259,204109,201259,t,3583
3584,854,581,857,0,202366,204658,202366,t,3584
3585,639,346,203290,0,500,204775,203290,g,3585
3586,1484,201065,937,0,1022,204508,201065,c,3586
3587,202324,1161,363,0,2401,206249,202324,a,3587
3588,335,152,206822,0,491,207800,206822,g,3588
3589,1060,402,585,0,205244,207291,205244,t,3589
3590,343,331,916,0,205585,207175,205585,t,3590
3591,390,249,270,0,207391,208300,207391,t,3591
3592,971,207437,291,0,932,209631,207437,c,3592
3593,316,189,433,0,208761,209699,208761,t,3593
3594,302,179,520,0,207892,208893,207892,t,3594
3595,239,158,314,0,207789,208500,207789,t,3595
3596,370,234,277,0,210431,211312,210431,t,3596
3597,280,286,211975,0,531,213072,211975,g,3597
3598,766,369,485,0,210769,212389,210769,t,3598
3599,262,165,210990,0,315,211732,210990,g,3599
3600,209330,605,216,0,603,210754,209330,a,3600
3601,920,208777,488,0,744,210929,208777,c,3601
3602,208927,718,346,0,220,210211,208927,a,3602
3603,156,103,293,0,209673,210225,209673,t,3603
3604,474,372,215,0,209339,210400,209339,t,3604
3605,287,173,209523,0,824,210807,209523,g,3605
3606,208400,953,350,0,354,210057,208400,a,3606
3607,300,164,573,0,209622,210659,209622,t,3607
3608,1768,207631,273,0,360,210032,207631,c,3608
3609,204325,542,861,0,1862,207590,204325,a,3609
3610,1336,204770,1442,0,1951,209499,204770,c,3610
3611,206993,961,245,0,2429,210628,206993,a,3611
3612,244,1491,209451,0,6417,217603,209451,g,3612
3613,598,368,217347,0,768,219081,217347,g,3613
3614,704,231,217403,0,585,218923,217403,g,3614
3615,216988,1130,315,0,475,218908,216988,a,3615
3616,216670,1101,389,0,973,219133,216670,a,3616
3617,1304,214198,3276,0,468,219246,214198,c,3617
3618,216249,551,599,0,442,217841,216249,a,3618
3619,378,2548,861,0,215455,219242,215455,t,3619
3620,352,317,219583,0,428,220680,219583,g,3620
3621,478,219,282,0,220278,221257,220278,t,3621
3622,1286,219179,388,0,2706,223559,219179,c,3622
3623,1364,219316,3352,0,1814,225846,219316,c,3623
3624,377,196,315,0,225237,226125,225237,t,3624
3625,430,186,3043,0,222321,225980,222321,t,3625
3626,284,166,430,0,224859,225739,224859,t,3626
3627,223569,854,337,0,537,225297,223569,a,3627
3628,428,232,223952,0,438,225050,223952,g,3628
3629,220074,1558,1377,0,546,223555,220074,a,3629
3630,331,139,222492,0,371,223333,222492,g,3630
3631,218784,1055,358,0,1373,221570,218784,a,3631
3632,1674,217370,1061,0,1820,221925,217370,c,3632
3633,2290,217569,1093,0,1011,221963,217569,c,3633
3634,784,516,730,0,220186,222216,220186,t,3634
3635,343,1906,220196,0,4079,226524,220196,g,3635
3636,504,161,219837,0,1687,222189,219837,g,3636
3637,1869,249,217877,0,554,220549,217877,g,3637
3638,212922,1708,341,0,1514,216485,212922,a,3638
3639,213900,1585,397,0,759,216641,213900,a,3639
3640,428,203,215399,0,519,216549,215399,g,3640
3641,213080,1873,310,0,3195,218458,213080,a,3641
3642,260,300,217976,0,1599,220135,217976,g,3642
3643,2018,3607,691,0,213425,219741,213425,t,3643
3644,323,283,218732,0,615,219953,218732,g,3644
3645,210963,1421,551,0,6035,218970,210963,a,3645
3646,3030,2454,944,0,212772,219200,212772,t,3646
3647,1158,1271,211981,0,7373,221783,211981,g,3647
3648,2460,223,215957,0,3014,221654,215957,g,3648
3649,2965,389,3259,0,214358,220971,214358,t,3649
3650,1576,2846,687,0,215575,220684,215575,t,3650
3651,213113,2088,886,0,2414,218501,213113,a,3651
3652,1241,2610,4049,0,208947,216847,208947,t,3652
3653,1467,981,208514,0,1104,212066,208514,g,3653
3654,3869,211,203304,0,1170,208554,203304,g,3654
3655,6383,2226,1814,0,195772,206195,195772,t,3655
3656,2721,1045,199324,0,1326,204416,199324,g,3656
3657,6116,322,195587,0,1313,203338,195587,g,3657
3658,1555,374,194877,0,4741,201547,194877,g,3658
3659,6075,191275,697,0,1309,199356,191275,c,3659
3660,1174,307,193487,0,1614,196582,193487,g,3660
3661,2776,188106,2323,0,1800,195005,188106,c,3661
3662,2156,1017,4831,0,186453,194457,186453,t,3662
3663,185243,2750,888,0,5094,193975,185243,a,3663
3664,1906,184987,5617,0,730,193240,184987,c,3664
3665,1738,473,3290,0,186543,192044,186543,t,3665
3666,186847,1059,2763,0,2056,192725,186847,a,3666
3667,1721,1255,3064,0,186940,192980,186940,t,3667
3668,1610,1155,187942,0,1363,192070,187942,g,3668
3669,185287,968,1326,0,3496,191077,185287,a,3669
3670,2497,184867,2985,0,5498,195847,184867,c,3670
3671,2501,673,187881,0,1053,192108,187881,g,3671
3672,1867,275,183391,0,1684,187217,183391,g,3672
3673,177787,1937,2443,0,1849,184016,177787,a,3673
3674,4686,1072,1685,0,176083,183526,176083,t,3674
3675,982,581,180290,0,610,182463,180290,g,3675
3676,175842,1169,2868,0,3845,183724,175842,a,3676
3677,4006,176796,2241,0,1799,184842,176796,c,3677
3678,178247,1738,3565,0,735,184285,178247,a,3678
3679,878,268,3732,0,179047,183925,179047,t,3679
3680,179162,2924,673,0,1039,183798,179162,a,3680
3681,857,710,181396,0,1058,184021,181396,g,3681
3682,1524,667,180349,0,701,183241,180349,g,3682
3683,2138,789,2163,0,177459,182549,177459,t,3683
3684,177452,1699,1309,0,816,181276,177452,a,3684
3685,1354,299,2197,0,177162,181012,177162,t,3685
3686,881,1068,178011,0,2711,182671,178011,g,3686
3687,871,198,181068,0,3614,185751,181068,g,3687
3688,651,217,184720,0,3188,188776,184720,g,3688
3689,3115,183376,413,0,2351,189255,183376,c,3689
3690,1075,186,187892,0,376,189529,187892,g,3690
3691,1589,490,839,0,187749,190667,187749,t,3691
3692,407,259,189738,0,870,191274,189738,g,3692
3693,188180,1091,631,0,7225,197127,188180,a,3693
3694,1374,195207,2269,0,1065,199915,195207,c,3694
3695,1517,270,678,0,197448,199913,197448,t,3695
3696,293,173,1446,0,198948,200860,198948,t,3696
3697,198373,1861,432,0,916,201582,198373,a,3697
3698,351,134,768,0,201269,202522,201269,t,3698
3699,1198,200659,574,0,273,202704,200659,c,3699
3700,257,140,881,0,201296,202574,201296,t,3700
3701,504,1326,632,0,200131,202593,200131,t,3701
3702,168,220,201572,0,660,202620,201572,g,3702
3703,1202,199331,1148,0,741,202422,199331,c,3703
3704,1069,199662,621,0,1060,202412,199662,c,3704
3705,835,199869,1040,0,224,201968,199869,c,3705
3706,327,186,637,0,200390,201540,200390,t,3706
3707,199364,1044,490,0,786,201684,199364,a,3707
3708,1060,199952,501,0,493,202006,199952,c,3708
3709,304,228,451,0,201457,202440,201457,t,3709
3710,200703,1174,282,0,2322,204481,200703,a,3710
3711,702,388,203952,0,2378,207420,203952,g,3711
3712,1312,206014,260,0,536,208122,206014,c,3712
3713,206405,1216,273,0,270,208164,206405,a,3713
3714,529,293,206484,0,419,207725,206484,g,3714
3715,1506,204803,254,0,1775,208338,204803,c,3715
3716,1057,206034,438,0,1207,208736,206034,c,3716
3717,423,199,382,0,207923,208927,207923,t,3717
3718,250,223,276,0,210578,211327,210578,t,3718
3719,980,210578,294,0,448,212300,210578,c,3719
3720,210017,1218,301,0,190,211726,210017,a,3720
3721,209852,880,407,0,1232,212371,209852,a,3721
3722,211227,1162,198,0,7263,219850,211227,a,3722
3723,582,217,221550,0,335,222684,221550,g,3723
3724,1049,469,449,0,220671,222638,220671,t,3724
3725,1294,221237,228,0,466,223225,221237,c,3725
3726,221720,865,320,0,2777,225682,221720,a,3726
3727,627,228,225235,0,1160,227250,225235,g,3727
3728,222637,1078,301,0,2178,226194,222637,a,3728
3729,1516,224378,888,0,2250,229032,224378,c,3729
3730,1356,227204,801,0,771,230132,227204,c,3730
3731,227951,1233,501,0,444,230129,227951,a,3731
3732,227844,1132,648,0,2269,231893,227844,a,3732
3733,1312,230373,473,0,369,232527,230373,c,3733
3734,359,282,781,0,231056,232478,231056,t,3734
3735,271,580,280,0,231236,232367,231236,t,3735
3736,189,233,885,0,231024,232331,231024,t,3736
3737,239,191,221,0,231428,232079,231428,t,3737
3738,531,309,230356,0,772,231968,230356,g,3738
3739,1286,228656,368,0,926,231236,228656,c,3739
3740,228269,1338,317,0,532,230456,228269,a,3740
3741,583,251,228927,0,2020,231781,228927,g,3741
3742,1824,228914,503,0,463,231704,228914,c,3742
3743,624,830,726,0,228496,230676,228496,t,3743
3744,657,338,228224,0,595,229814,228224,g,3744
3745,592,220,224109,0,463,225384,224109,g,3745
3746,218757,1950,722,0,1798,223227,218757,a,3746
3747,2696,217942,1536,0,416,222590,217942,c,3747
3748,1765,508,1993,0,215015,219281,215015,t,3748
3749,215327,1352,1163,0,1538,219380,215327,a,3749
3750,1941,214811,2398,0,980,220130,214811,c,3750
3751,398,741,592,0,220467,222198,220467,t,3751
3752,936,219878,2024,0,393,223231,219878,c,3752
3753,640,257,2000,0,220918,223815,220918,t,3753
3754,1629,608,1081,0,222799,226117,222799,t,3754
3755,1068,300,224638,0,2902,228908,224638,g,3755
3756,226135,1796,1340,0,1156,230427,226135,a,3756
3757,673,241,229245,0,399,230558,229245,g,3757
3758,226019,1738,291,0,565,228613,226019,a,3758
3759,223689,1421,1765,0,878,227753,223689,a,3759
3760,224293,1825,413,0,2376,228907,224293,a,3760
3761,765,311,227434,0,774,229284,227434,g,3761
3762,1558,688,767,0,225268,228281,225268,t,3762
3763,1464,662,688,0,224702,227516,224702,t,3763
3764,548,225,225087,0,761,226621,225087,g,3764
3765,220465,974,409,0,965,222813,220465,a,3765
3766,1496,218559,1220,0,1784,223059,218559,c,3766
3767,3602,207013,1425,0,345,212385,207013,c,3767
3768,513,309,1082,0,209914,211818,209914,t,3768
3769,1241,207908,1530,0,1052,211731,207908,c,3769
3770,1396,205276,3160,0,2644,212476,205276,c,3770
3771,208064,1521,2163,0,911,212659,208064,a,3771
3772,207121,874,1792,0,1348,211135,207121,a,3772
3773,1278,300,209193,0,664,211435,209193,g,3773
3774,1041,289,208148,0,799,210277,208148,g,3774
3775,206269,1497,1259,0,1473,210498,206269,a,3775
3776,206451,1752,1388,0,612,210203,206451,a,3776
3777,1357,676,1826,0,206694,210553,206694,t,3777
3778,1530,1013,1415,0,206060,210018,206060,t,3778
3779,724,769,207465,0,815,209773,207465,g,3779
3780,204551,1144,1609,0,2398,209702,204551,a,3780
3781,1759,319,1229,0,207208,210515,207208,t,3781
3782,625,397,204876,0,986,206884,204876,g,3782
3783,201373,1164,1018,0,1978,205533,201373,a,3783
3784,2309,594,1487,0,201721,206111,201721,t,3784
3785,908,590,202776,0,623,204897,202776,g,3785
3786,200833,1488,987,0,2423,205731,200833,a,3786
3787,3527,199485,1761,0,864,205637,199485,c,3787
3788,1098,988,2976,0,194979,200041,194979,t,3788
3789,196260,1663,820,0,1210,199953,196260,a,3789
3790,1756,193860,3697,0,1418,200731,193860,c,3790
3791,1269,195640,1638,0,1980,200527,195640,c,3791
3792,194401,1165,4178,0,2396,202140,194401,a,3792
3793,626,261,806,0,202050,203743,202050,t,3793
3794,200748,1777,1029,0,814,204368,200748,a,3794
3795,916,320,202829,0,983,205048,202829,g,3795
3796,1252,269,202737,0,817,205075,202737,g,3796
3797,200308,1124,1348,0,2011,204791,200308,a,3797
3798,202559,1405,583,0,681,205228,202559,a,3798
3799,1240,252,2017,0,203385,206894,203385,t,3799
3800,2467,204011,391,0,2147,209016,204011,c,3800
3801,291,168,208550,0,731,209740,208550,g,3801
3802,1102,411,790,0,206549,208852,206549,t,3802
3803,205316,794,1678,0,4106,211894,205316,a,3803
3804,1556,208177,1519,0,1225,212477,208177,c,3804
3805,1734,237,532,0,209963,212466,209963,t,3805
3806,1293,209030,1462,0,1499,213284,209030,c,3806
3807,2045,209655,801,0,389,212890,209655,c,3807
3808,521,332,475,0,210667,211995,210667,t,3808
3809,1138,209237,559,0,414,211348,209237,c,3809
3810,520,691,726,0,208325,210262,208325,t,3810
3811,1018,207083,692,0,600,209393,207083,c,3811
3812,1133,203940,1536,0,834,207443,203940,c,3812
3813,1785,201168,749,0,681,204383,201168,c,3813
3814,201547,964,539,0,1233,204283,201547,a,3814
3815,724,243,201994,0,436,203397,201994,g,3815
3816,200153,1257,600,0,642,202652,200153,a,3816
3817,717,277,200878,0,1502,203374,200878,g,3817
3818,1270,198204,733,0,548,200755,198204,c,3818
3819,196865,994,2099,0,827,200785,196865,a,3819
3820,1042,195807,772,0,2166,199787,195807,c,3820
3821,1348,195933,440,0,463,198184,195933,c,3821
3822,194160,883,2220,0,368,197631,194160,a,3822
3823,606,252,2006,0,193183,196047,193183,t,3823
3824,192415,652,1060,0,2689,196816,192415,a,3824
3825,1620,193232,969,0,4491,200312,193232,c,3825
3826,1950,196517,1196,0,2087,201750,196517,c,3826
3827,198990,793,1980,0,873,202636,198990,a,3827
3828,988,346,200574,0,1141,203049,200574,g,3828
3829,192236,1738,952,0,1686,196612,192236,a,3829
3830,1771,379,194017,0,535,196702,194017,g,3830
3831,185006,1364,605,0,2532,189507,185006,a,3831
3832,2311,181949,2149,0,4319,190728,181949,c,3832
3833,1643,185693,3002,0,890,191228,185693,c,3833
3834,185896,2078,1707,0,996,190677,185896,a,3834
3835,881,444,4568,0,184817,190710,184817,t,3835
3836,581,720,556,0,195784,197641,195784,t,3836
3837,1358,197521,1729,0,437,201045,197521,c,3837
3838,567,212,4083,0,195803,200665,195803,t,3838
3839,1535,556,830,0,197721,200642,197721,t,3839
3840,462,218,199175,0,816,200671,199175,g,3840
3841,192409,890,565,0,3204,197068,192409,a,3841
3842,192644,865,1161,0,2195,196865,192644,a,3842
3843,1866,190792,3024,0,489,196171,190792,c,3843
3844,1632,427,3204,0,187246,192509,187246,t,3844
3845,571,632,190261,0,399,191863,190261,g,3845
3846,188288,1143,797,0,1036,191264,188288,a,3846
3847,3007,186539,1197,0,713,191456,186539,c,3847
3848,4174,509,1751,0,178343,184777,178343,t,3848
3849,312,166,183217,0,421,184116,183217,g,3849
3850,181271,1277,461,0,684,183693,181271,a,3850
3851,2012,418,604,0,179584,182618,179584,t,3851
3852,368,711,181439,0,1429,183947,181439,g,3852
3853,2289,178617,1011,0,4398,186315,178617,c,3853
3854,700,206,185187,0,429,186522,185187,g,3854
3855,2185,578,1600,0,180139,184502,180139,t,3855
3856,1428,435,1296,0,181824,184983,181824,t,3856
3857,179880,3060,1048,0,822,184810,179880,a,3857
3858,1299,357,182157,0,1439,185252,182157,g,3858
3859,1123,179567,465,0,4895,186050,179567,c,3859
3860,881,180764,4184,0,430,186259,180764,c,3860
3861,656,616,869,0,183405,185546,183405,t,3861
3862,3082,1950,227,0,180353,185612,180353,t,3862
3863,442,620,183537,0,1071,185670,183537,g,3863
3864,964,537,180964,0,2589,185054,180964,g,3864
3865,917,383,180240,0,1747,183287,180240,g,3865
3866,3379,173903,2126,0,835,180243,173903,c,3866
3867,178337,709,547,0,1888,181481,178337,a,3867
3868,4053,634,663,0,177026,182376,177026,t,3868
3869,303,433,181526,0,447,182709,181526,g,3869
3870,179641,1116,832,0,1022,182611,179641,a,3870
3871,816,410,3273,0,177939,182438,177939,t,3871
3872,932,1892,178160,0,1885,182869,178160,g,3872
3873,672,238,181794,0,408,183112,181794,g,3873
3874,1082,344,478,0,180935,182839,180935,t,3874
3875,1528,178933,576,0,3454,184491,178933,c,3875
3876,929,180979,2815,0,681,185404,180979,c,3876
3877,637,204,655,0,182970,184466,182970,t,3877
3878,234,732,1225,0,182593,184784,182593,t,3878
3879,182394,995,527,0,1001,184917,182394,a,3879
3880,182433,1245,648,0,654,184980,182433,a,3880
3881,181668,1620,1118,0,481,184887,181668,a,3881
3882,182050,1163,781,0,618,184612,182050,a,3882
3883,372,275,1316,0,182674,184637,182674,t,3883
3884,1159,602,181349,0,613,183723,181349,g,3884
3885,929,147,182053,0,589,183718,182053,g,3885
3886,1654,866,643,0,180318,183481,180318,t,3886
3887,467,868,180557,0,731,182623,180557,g,3887
3888,176526,1106,1088,0,3779,182499,176526,a,3888
3889,367,269,183050,0,604,184290,183050,g,3889
3890,181577,958,638,0,740,183913,181577,a,3890
3891,181981,837,559,0,877,184254,181981,a,3891
3892,180923,997,1521,0,300,183741,180923,a,3892
3893,180049,937,1165,0,902,183053,180049,a,3893
3894,179007,1130,603,0,1131,181871,179007,a,3894
3895,347,618,2141,0,180202,183308,180202,t,3895
3896,361,395,177253,0,1489,179498,177253,g,3896
3897,300,238,178049,0,941,179528,178049,g,3897
3898,177009,1014,504,0,960,179487,177009,a,3898
3899,177261,1204,603,0,335,179403,177261,a,3899
3900,174876,963,2957,0,629,179425,174876,a,3900
3901,177335,1089,335,0,731,179490,177335,a,3901
3902,419,277,178268,0,2117,181081,178268,g,3902
3903,1358,2978,977,0,175252,180565,175252,t,3903
3904,175674,702,3845,0,453,180674,175674,a,3904
3905,327,181,654,0,178719,179881,178719,t,3905
3906,1839,177236,476,0,518,180069,177236,c,3906
3907,174017,690,2841,0,1859,179407,174017,a,3907
3908,173472,991,1365,0,1643,177471,173472,a,3908
3909,401,221,1967,0,174788,177377,174788,t,3909
3910,2065,1743,422,0,172614,176844,172614,t,3910
3911,711,354,173364,0,886,175315,173364,g,3911
3912,622,280,172080,0,751,173733,172080,g,3912
3913,2853,164262,2407,0,1200,170722,164262,c,3913
3914,163170,798,847,0,1079,165894,163170,a,3914
3915,1588,378,162791,0,942,165699,162791,g,3915
3916,3491,914,1448,0,159116,164969,159116,t,3916
3917,338,264,163333,0,595,164530,163333,g,3917
3918,159403,1788,500,0,2583,164274,159403,a,3918
3919,2954,157342,2686,0,849,163831,157342,c,3919
3920,805,871,3636,0,153995,159307,153995,t,3920
3921,155684,807,1647,0,955,159093,155684,a,3921
3922,880,159,2073,0,156443,159555,156443,t,3922
3923,1329,154393,629,0,1077,157428,154393,c,3923
3924,152758,585,2135,0,3125,158603,152758,a,3924
3925,1169,809,1340,0,159084,162402,159084,t,3925
3926,856,832,162165,0,1923,165776,162165,g,3926
3927,1125,212,163198,0,2343,166878,163198,g,3927
3928,2513,161298,1704,0,1028,166543,161298,c,3928
3929,1558,870,1569,0,161674,165671,161674,t,3929
3930,162960,650,1166,0,562,165338,162960,a,3930
3931,415,104,1162,0,165149,166830,165149,t,3931
3932,1499,165222,422,0,644,167787,165222,c,3932
3933,569,140,2084,0,164577,167370,164577,t,3933
3934,781,782,375,0,166394,168332,166394,t,3934
3935,273,137,167961,0,615,168986,167961,g,3935
3936,1150,285,711,0,166521,168667,166521,t,3936
3937,1323,216,166182,0,558,168279,166182,g,3937
3938,1465,162218,1494,0,784,165961,162218,c,3938
3939,1127,103,162041,0,308,163579,162041,g,3939
3940,747,663,804,0,163150,165364,163150,t,3940
3941,1671,164516,368,0,604,167159,164516,c,3941
3942,1668,161839,1923,0,1879,167309,161839,c,3942
3943,1630,157543,2228,0,740,162141,157543,c,3943
3944,157222,560,1824,0,607,160213,157222,a,3944
3945,158139,575,947,0,788,160449,158139,a,3945
3946,156992,825,2064,0,1042,160923,156992,a,3946
3947,1296,486,717,0,158434,160933,158434,t,3947
3948,557,185,158548,0,2431,161721,158548,g,3948
3949,1415,158049,1164,0,1702,162330,158049,c,3949
3950,158553,1020,813,0,2024,162410,158553,a,3950
3951,691,155,160531,0,1692,163069,160531,g,3951
3952,2792,1120,1021,0,154955,159888,154955,t,3952
3953,268,423,158531,0,751,159973,158531,g,3953
3954,156563,1087,1023,0,1445,160118,156563,a,3954
3955,1193,297,1151,0,159052,161693,159052,t,3955
3956,159287,1615,496,0,1037,162435,159287,a,3956
3957,260,107,2630,0,160430,163427,160430,t,3957
3958,788,388,1305,0,162866,165347,162866,t,3958
3959,163629,586,1337,0,3247,168799,163629,a,3959
3960,1099,166933,999,0,1317,170348,166933,c,3960
3961,167848,505,1260,0,399,170012,167848,a,3961
3962,166782,606,1403,0,1691,170482,166782,a,3962
3963,168066,1690,525,0,339,170620,168066,a,3963
3964,167049,858,1689,0,3105,172701,167049,a,3964
3965,1607,170781,313,0,1135,173836,170781,c,3965
3966,926,295,169173,0,667,171061,169173,g,3966
3967,1209,166478,1145,0,1984,170816,166478,c,3967
3968,165017,1299,1160,0,1409,168885,165017,a,3968
3969,350,277,1959,0,167989,170575,167989,t,3969
3970,374,1392,169266,0,980,172012,169266,g,3970
3971,337,161,170798,0,1696,172992,170798,g,3971
3972,170271,1140,1538,0,1103,174052,170271,a,3972
3973,172645,932,433,0,866,174876,172645,a,3973
3974,173314,1038,364,0,3037,177753,173314,a,3974
3975,455,229,178020,0,565,179269,178020,g,3975
3976,3814,935,584,0,173951,179284,173951,t,3976
3977,315,237,178391,0,697,179640,178391,g,3977
3978,174396,2222,516,0,5717,182851,174396,a,3978
3979,381,255,183380,0,634,184650,183380,g,3979
3980,752,424,564,0,180248,181988,180248,t,3980
3981,1856,714,293,0,183170,186033,183170,t,3981
3982,305,216,186509,0,1514,188544,186509,g,3982
3983,1601,184664,727,0,1607,188599,184664,c,3983
3984,183932,1698,1060,0,1925,188615,183932,a,3984
3985,1991,184812,884,0,655,188342,184812,c,3985
3986,182231,1264,1109,0,763,185367,182231,a,3986
3987,182597,1366,938,0,552,185453,182597,a,3987
3988,669,223,2030,0,182951,185873,182951,t,3988
3989,182931,1157,1120,0,819,186027,182931,a,3989
3990,432,220,1442,0,184411,186505,184411,t,3990
3991,580,912,405,0,185853,187750,185853,t,3991
3992,383,387,186830,0,1141,188741,186830,g,3992
3993,454,174,186480,0,1981,189089,186480,g,3993
3994,1848,185397,616,0,687,188548,185397,c,3994
3995,184458,1485,834,0,848,187625,184458,a,3995
3996,699,264,185913,0,503,187379,185913,g,3996
3997,1629,641,1044,0,184096,187410,184096,t,3997
3998,532,922,185160,0,897,187511,185160,g,3998
3999,464,291,186062,0,551,187368,186062,g,3999
4000,1706,891,1518,0,186589,190704,186589,t,4000
4001,579,546,189355,0,1970,192450,189355,g,4001
4002,614,281,638,0,190904,192437,190904,t,4002
4003,2359,188606,549,0,3986,195500,188606,c,4003
4004,1517,193159,1041,0,2735,198452,193159,c,4004
4005,651,210,197877,0,657,199395,197877,g,4005
4006,915,519,985,0,196417,198836,196417,t,4006
4007,721,542,671,0,196510,198444,196510,t,4007
4008,452,169,345,0,198667,199633,198667,t,4008
4009,1503,197150,466,0,1014,200133,197150,c,4009
4010,1502,196150,970,0,771,199393,196150,c,4010
4011,1202,195569,1071,0,1590,199432,195569,c,4011
4012,1603,194884,1076,0,931,198494,194884,c,4012
4013,194012,1996,685,0,2249,198942,194012,a,4013
4014,1937,195829,1172,0,1018,199956,195829,c,4014
4015,1105,635,561,0,199389,201690,199389,t,4015
4016,359,359,200872,0,1162,202752,200872,g,4016
4017,1518,507,1115,0,200391,203531,200391,t,4017
4018,699,289,628,0,203402,205018,203402,t,4018
4019,1343,201828,910,0,2086,206167,201828,c,4019
4020,460,219,1446,0,204403,206528,204403,t,4020
4021,310,144,1448,0,205033,206935,205033,t,4021
4022,204561,1022,525,0,1096,207204,204561,a,4022
4023,205352,886,525,0,2851,209614,205352,a,4023
4024,2240,206165,1545,0,1091,211041,206165,c,4024
4025,203582,1778,767,0,1263,207390,203582,a,4025
4026,630,189,1347,0,205043,207209,205043,t,4026
4027,1609,203680,702,0,2462,208453,203680,c,4027
4028,1679,203566,2303,0,1472,209020,203566,c,4028
4029,635,786,1688,0,206124,209233,206124,t,4029
4030,2420,204343,809,0,1379,208951,204343,c,4030
4031,203947,1788,893,0,3336,209964,203947,a,4031
4032,2284,204049,2397,0,1814,210544,204049,c,4032
4033,206302,1690,1295,0,1547,210834,206302,a,4033
4034,901,441,208200,0,3387,212929,208200,g,4034
4035,1669,209834,1229,0,1164,213896,209834,c,4035
4036,208804,2028,2547,0,973,214352,208804,a,4036
4037,719,206,210065,0,1144,212134,210065,g,4037
4038,208518,1112,787,0,1294,211711,208518,a,4038
4039,208495,830,1410,0,2824,213559,208495,a,4039
4040,210210,976,1969,0,1991,215146,210210,a,4040
4041,1597,528,212116,0,1238,215479,212116,g,4041
4042,1879,209612,2292,0,1835,215618,209612,c,4042
4043,798,463,212859,0,877,214997,212859,g,4043
4044,322,287,212498,0,2353,215460,212498,g,4044
4045,203049,2844,1476,0,3904,211273,203049,a,4045
4046,1120,919,1429,0,207158,210626,207158,t,4046
4047,754,1888,715,0,207471,210828,207471,t,4047
4048,1297,473,208226,0,2273,212269,208226,g,4048
4049,548,739,209634,0,2069,212990,209634,g,4049
4050,207312,1138,1799,0,2916,213165,207312,a,4050
4051,2738,683,2427,0,207473,213321,207473,t,4051
4052,203185,2146,1910,0,2974,210215,203185,a,4052
4053,1864,202512,2753,0,3187,210316,202512,c,4053
4054,1468,203492,2643,0,2273,209876,203492,c,4054
4055,202374,2071,1840,0,4119,210404,202374,a,4055
4056,1838,385,1424,0,207062,210709,207062,t,4056
4057,564,468,2029,0,207570,210631,207570,t,4057
4058,204910,1580,2080,0,2176,210746,204910,a,4058
4059,1727,775,206881,0,1545,210928,206881,g,4059
4060,1465,204654,2070,0,2568,210757,204654,c,4060
4061,203146,1965,2180,0,3508,210799,203146,a,4061
4062,695,502,1492,0,209641,212330,209641,t,4062
4063,806,573,619,0,211463,213461,211463,t,4063
4064,909,696,207018,0,4734,213357,207018,g,4064
4065,205855,2060,1627,0,3123,212665,205855,a,4065
4066,4149,205921,1218,0,1254,212542,205921,c,4066
4067,740,621,207656,0,1899,210916,207656,g,4067
4068,202988,1834,1359,0,3486,209667,202988,a,4068
4069,1211,567,1453,0,207591,210822,207591,t,4069
4070,2499,206324,732,0,1801,211356,206324,c,4070
4071,205862,2190,1047,0,2390,211489,205862,a,4071
4072,203947,2560,1630,0,1928,210065,203947,a,4072
4073,1924,673,206015,0,1662,210274,206015,g,4073
4074,1694,1357,204935,0,1915,209901,204935,g,4074
4075,1159,621,203871,0,5409,211060,203871,g,4075
4076,1142,858,1241,0,210214,213455,210214,t,4076
4077,1415,207823,2131,0,2761,214130,207823,c,4077
4078,690,731,1061,0,212330,214812,212330,t,4078
4079,2401,209899,1374,0,1359,215033,209899,c,4079
4080,210418,1679,1727,0,1291,215115,210418,a,4080
4081,210198,1318,1014,0,1805,214335,210198,a,4081
4082,982,450,1121,0,212817,215370,212817,t,4082
4083,1584,211243,1137,0,1860,215824,211243,c,4083
4084,1589,211262,1665,0,1527,216043,211262,c,4084
4085,211052,2137,970,0,1026,215185,211052,a,4085
4086,211180,1118,1152,0,2071,215521,211180,a,4086
4087,2512,210121,2109,0,1326,216068,210121,c,4087
4088,201671,990,1138,0,1254,205053,201671,a,4088
4089,692,368,201832,0,1009,203901,201832,g,4089
4090,3702,195493,1383,0,3018,203596,195493,c,4090
4091,646,496,1407,0,201391,203940,201391,t,4091
4092,197669,2628,1278,0,2665,204240,197669,a,4092
4093,760,561,3085,0,199998,204404,199998,t,4093
4094,803,745,1379,0,202271,205198,202271,t,4094
4095,737,1603,1441,0,202096,205877,202096,t,4095
4096,541,564,2587,0,201817,205509,201817,t,4096
4097,404,345,822,0,203680,205251,203680,t,4097
4098,1496,198685,2670,0,1959,204810,198685,c,4098
4099,744,215,1796,0,200313,203068,200313,t,4099
4100,197162,701,1318,0,1132,200313,197162,a,4100
4101,194030,949,2143,0,1535,198657,194030,a,4101
4102,2447,192174,3218,0,921,198760,192174,c,4102
4103,193446,823,1794,0,805,196868,193446,a,4103
4104,190825,1621,2302,0,1811,196559,190825,a,4104
4105,2634,190888,1806,0,1139,196467,190888,c,4105
4106,2801,189436,1663,0,1786,195686,189436,c,4106
4107,1576,188293,3375,0,2917,196161,188293,c,4107
4108,1118,646,1255,0,193627,196646,193627,t,4108
4109,491,636,2976,0,193012,197115,193012,t,4109
4110,552,318,1086,0,197411,199367,197411,t,4110
4111,2567,194570,2153,0,1325,200615,194570,c,4111
4112,193757,1499,1986,0,1611,198853,193757,a,4112
4113,191432,1024,1758,0,1862,196076,191432,a,4113
4114,1475,406,193396,0,1413,196690,193396,g,4114
4115,186388,1528,978,0,1643,190537,186388,a,4115
4116,182636,1350,2499,0,3735,190220,182636,a,4116
4117,2376,183835,1536,0,3856,191603,183835,c,4117
4118,2918,182753,3208,0,2155,191034,182753,c,4118
4119,183433,1394,4012,0,1570,190409,183433,a,4119
4120,184400,1083,2009,0,5324,192816,184400,a,4120
4121,3399,185902,3366,0,3784,196451,185902,c,4121
4122,189697,2425,1668,0,3461,197251,189697,a,4122
4123,191966,1406,3390,0,2822,199584,191966,a,4123
4124,1918,604,197039,0,2015,201576,197039,g,4124
4125,193951,1980,2464,0,2087,200482,193951,a,4125
4126,194260,1185,2868,0,1853,200166,194260,a,4126
4127,193721,1597,2133,0,2047,199498,193721,a,4127
4128,193940,1550,2111,0,1766,199367,193940,a,4128
4129,3445,906,192921,0,1239,198511,192921,g,4129
4130,1335,973,192467,0,1146,195921,192467,g,4130
4131,188081,1891,3079,0,2719,195770,188081,a,4131
4132,1459,714,189396,0,6198,197767,189396,g,4132
4133,2184,189005,1936,0,4961,198086,189005,c,4133
4134,1598,1277,3626,0,191348,197849,191348,t,4134
4135,1692,1359,192669,0,2263,197983,192669,g,4135
4136,2334,531,190197,0,3420,196482,190197,g,4136
4137,2763,187093,3155,0,4865,197876,187093,c,4137
4138,3685,183547,4749,0,3699,195680,183547,c,4138
4139,186339,1623,2892,0,5602,196456,186339,a,4139
4140,2483,186025,4241,0,3969,196718,186025,c,4140
4141,1100,720,2829,0,191067,195716,191067,t,4141
4142,190771,1089,2534,0,2159,196553,190771,a,4142
4143,191675,1327,2404,0,1580,196986,191675,a,4143
4144,189914,1224,2787,0,3509,197434,189914,a,4144
4145,4536,541,1204,0,191495,197776,191495,t,4145
4146,1069,982,193527,0,2336,197914,193527,g,4146
4147,190788,2384,1935,0,4309,199416,190788,a,4147
4148,1407,746,196771,0,2085,201009,196771,g,4148
4149,1167,799,192730,0,5646,200342,192730,g,4149
4150,2639,189019,3995,0,5723,201376,189019,c,4150
4151,1412,935,2939,0,195206,200492,195206,t,4151
4152,192692,1533,1098,0,5255,200578,192692,a,4152
4153,1506,245,2586,0,196823,201160,196823,t,4153
4154,2063,193965,2196,0,3172,201396,193965,c,4154
4155,192742,1570,1547,0,6669,202528,192742,a,4155
4156,1762,1928,2657,0,197028,203375,197028,t,4156
4157,1250,871,199216,0,2147,203484,199216,g,4157
4158,1410,600,199192,0,1662,202864,199192,g,4158
4159,3335,192355,2566,0,2478,200734,192355,c,4159
4160,190337,2046,2467,0,2994,197844,190337,a,4160
4161,1824,478,193316,0,2294,197912,193316,g,4161
4162,2242,1211,1167,0,193009,197629,193009,t,4162
4163,2601,191946,1662,0,3186,199395,191946,c,4163
4164,971,1088,196131,0,2047,200237,196131,g,4164
4165,2299,950,191570,0,1940,196759,191570,g,4165
4166,1915,710,189351,0,1409,193385,189351,g,4166
4167,184152,2198,1398,0,3293,191041,184152,a,4167
4168,2796,1056,2510,0,184867,191229,184867,t,4168
4169,2013,2587,183683,0,2029,190312,183683,g,4169
4170,2124,581,184804,0,3416,190925,184804,g,4170
4171,4664,1894,3339,0,183222,193119,183222,t,4171
4172,2029,845,189255,0,5765,197894,189255,g,4172
4173,193500,1463,1613,0,3391,199967,193500,a,4173
4174,1817,669,196023,0,1686,200195,196023,g,4174
4175,2755,190666,1866,0,4983,200270,190666,c,4175
4176,192468,1703,3641,0,3417,201229,192468,a,4176
4177,989,812,1454,0,197760,201015,197760,t,4177
4178,1171,1901,1719,0,196014,200805,196014,t,4178
4179,765,775,2006,0,196441,199987,196441,t,4179
4180,1522,1771,1096,0,195881,200270,195881,t,4180
4181,734,474,197934,0,1239,200381,197934,g,4181
4182,1114,398,195905,0,1483,198900,195905,g,4182
4183,2900,190781,1725,0,1739,197145,190781,c,4183
4184,2279,189658,2970,0,1340,196247,189658,c,4184
4185,190921,1234,1226,0,3837,197218,190921,a,4185
4186,732,464,194937,0,2073,198206,194937,g,4186
4187,2556,527,1036,0,193132,197251,193132,t,4187
4188,891,418,2607,0,193446,197362,193446,t,4188
4189,1984,191872,1858,0,1515,197229,191872,c,4189
4190,191600,2031,1176,0,2039,196846,191600,a,4190
4191,2001,190171,2997,0,1666,196835,190171,c,4191
4192,1319,383,1353,0,193314,196369,193314,t,4192
4193,1668,190805,834,0,3100,196407,190805,c,4193
4194,841,191379,2721,0,2140,197081,191379,c,4194
4195,1123,423,1310,0,194630,197486,194630,t,4195
4196,193556,1145,2078,0,752,197531,193556,a,4196
4197,194437,865,1221,0,1123,197646,194437,a,4197
4198,193927,1496,1229,0,2189,198841,193927,a,4198
4199,916,380,196960,0,1142,199398,196960,g,4199
4200,193973,1240,864,0,2744,198821,193973,a,4200
4201,193155,1057,2580,0,4059,200851,193155,a,4201
4202,1112,666,987,0,199801,202566,199801,t,4202
4203,650,311,200338,0,992,202291,200338,g,4203
4204,196400,2069,966,0,2167,201602,196400,a,4204
4205,2085,195341,1798,0,2263,201487,195341,c,4205
4206,191775,2135,1331,0,2152,197393,191775,a,4206
4207,1602,143,1468,0,193901,197114,193901,t,4207
4208,641,1141,713,0,195166,197661,195166,t,4208
4209,1281,193658,1211,0,2195,198345,193658,c,4209
4210,1251,193228,2578,0,2871,199928,193228,c,4210
4211,1257,192911,3355,0,1115,198638,192911,c,4211
4212,189552,1496,2671,0,1727,195446,189552,a,4212
4213,2413,315,1834,0,188937,193499,188937,t,4213
4214,1087,910,190713,0,1005,193715,190713,g,4214
4215,188173,1348,1551,0,4660,195732,188173,a,4215
4216,2427,189269,2227,0,3360,197283,189269,c,4216
4217,189700,3739,2037,0,3377,198853,189700,a,4217
4218,1307,535,196953,0,1982,200777,196953,g,4218
4219,884,454,198321,0,1179,200838,198321,g,4219
4220,194292,2236,1642,0,2734,200904,194292,a,4220
4221,3516,193659,2328,0,2284,201787,193659,c,4221
4222,1992,193915,3329,0,2353,201589,193915,c,4222
4223,194805,1943,2118,0,3297,202163,194805,a,4223
4224,1219,440,3169,0,197088,201916,197088,t,4224
4225,1079,619,1473,0,199474,202645,199474,t,4225
4226,195788,2899,1982,0,3300,203969,195788,a,4226
4227,1753,634,199985,0,2045,204417,199985,g,4227
4228,1586,1076,2619,0,199422,204703,199422,t,4228
4229,740,495,203465,0,1753,206453,203465,g,4229
4230,955,465,201916,0,4957,208293,201916,g,4230
4231,2857,201925,1862,0,3324,209968,201925,c,4231
4232,1615,740,2625,0,204937,209917,204937,t,4232
4233,1424,681,205619,0,2336,210060,205619,g,4233
4234,785,717,206510,0,1923,209935,206510,g,4234
4235,194503,4879,7840,0,4183,211405,194503,a,4235
4236,3684,1202,206499,0,2243,213628,206499,g,4236
4237,2187,437,208841,0,3399,214864,208841,g,4237
4238,1018,402,211602,0,3076,216098,211602,g,4238
4239,3169,203754,5187,0,4465,216575,203754,c,4239
4240,3152,7086,1987,0,210334,222559,210334,t,4240
4241,2344,219516,1824,0,3934,227618,219516,c,4241
4242,2339,221857,1317,0,2884,228397,221857,c,4242
4243,1342,4259,1069,0,221410,228080,221410,t,4243
4244,2391,221617,1591,0,2360,227959,221617,c,4244
4245,212497,11063,1286,0,3102,227948,212497,a,4245
4246,4948,218875,1224,0,3032,228079,218875,c,4246
4247,1423,3426,2105,0,220270,227224,220270,t,4247
4248,853,933,220099,0,4948,226833,220099,g,4248
4249,1537,1266,3671,0,219803,226277,219803,t,4249
4250,589,575,221076,0,3762,226002,221076,g,4250
4251,1395,1126,5124,0,218428,226073,218428,t,4251
4252,670,910,221225,0,3419,226224,221225,g,4252
4253,3092,213879,2320,0,3994,223285,213879,c,4253
4254,1271,2648,2150,0,216896,222965,216896,t,4254
4255,213461,4054,1020,0,4456,222991,213461,a,4255
4256,5138,215705,1317,0,2422,224582,215705,c,4256
4257,1407,4608,216617,0,2180,224812,216617,g,4257
4258,2429,2113,5511,0,216896,226949,216896,t,4258
4259,714,1347,223018,0,3851,228930,223018,g,4259
4260,2767,221152,2415,0,2619,228953,221152,c,4260
4261,1767,4593,1875,0,220512,228747,220512,t,4261
4262,2293,223128,1572,0,1762,228755,223128,c,4262
4263,215619,9531,786,0,3237,229173,215619,a,4263
4264,4144,221794,1545,0,2090,229573,221794,c,4264
4265,2126,5109,1648,0,223707,232590,223707,t,4265
4266,1091,1513,229146,0,3609,235359,229146,g,4266
4267,1033,466,231819,0,1538,234856,231819,g,4267
4268,223591,4365,3835,0,1630,233421,223591,a,4268
4269,6164,224666,1669,0,894,233393,224666,c,4269
4270,1698,2980,225894,0,920,231492,225894,g,4270
4271,219179,5507,3712,0,2104,230502,219179,a,4271
4272,6768,2089,2458,0,219174,230489,219174,t,4272
4273,3479,223487,1288,0,2487,230741,223487,c,4273
4274,1369,2829,225318,0,4495,234011,225318,g,4274
4275,1446,614,226221,0,3396,231677,226221,g,4275
4276,3077,222905,4086,0,1506,231574,222905,c,4276
4277,3653,221434,2453,0,632,228172,221434,c,4277
4278,1221,2069,221271,0,1430,225991,221271,g,4278
4279,206785,6453,10156,0,2307,225701,206785,a,4279
4280,3009,1393,2582,0,218376,225360,218376,t,4280
4281,1471,1361,1348,0,221321,225501,221321,t,4281
4282,893,1565,3396,0,219921,225775,219921,t,4282
4283,1204,933,217380,0,6604,226121,217380,g,4283
4284,1038,596,222733,0,1108,225475,222733,g,4284
4285,211745,3900,8182,0,1426,225253,211745,a,4285
4286,218554,2197,1459,0,3581,225791,218554,a,4286
4287,7061,216222,2097,0,1844,227224,216222,c,4287
4288,1863,2423,5016,0,217842,227144,217842,t,4288
4289,961,909,222588,0,3659,228117,222588,g,4289
4290,2026,774,224001,0,1338,228139,224001,g,4290
4291,212120,3244,9600,0,1415,226379,212120,a,4291
4292,4168,787,218353,0,1038,224346,218353,g,4292
4293,215451,2677,4326,0,1151,223605,215451,a,4293
4294,3427,635,218301,0,1255,223618,218301,g,4294
4295,211498,4727,5479,0,3176,224880,211498,a,4295
4296,3163,761,219698,0,2308,225930,219698,g,4296
4297,3323,214789,3719,0,5387,227218,214789,c,4297
4298,2815,218347,2656,0,2386,226204,218347,c,4298
4299,1477,3896,220348,0,2618,228339,220348,g,4299
4300,2811,216861,3431,0,3683,226786,216861,c,4300
4301,3328,216854,5391,0,678,226251,216854,c,4301
4302,1284,4794,215337,0,2332,223747,215337,g,4302
4303,207554,7824,5619,0,1669,222666,207554,a,4303
4304,3769,2912,5073,0,213620,225374,213620,t,4304
4305,1390,2411,219717,0,2621,226139,219717,g,4305
4306,1758,1523,9128,0,215073,227482,215073,t,4306
4307,4094,217421,4320,0,2043,227878,217421,c,4307
4308,215725,7458,3068,0,733,226984,215725,a,4308
4309,218784,3296,2717,0,1418,226215,218784,a,4309
4310,216435,2738,5012,0,1902,226087,216435,a,4310
4311,8043,1750,2595,0,214599,226987,214599,t,4311
4312,2169,2305,218351,0,11645,234470,218351,g,4312
4313,1065,1492,233326,0,2138,238021,233326,g,4313
4314,966,540,235136,0,643,237285,235136,g,4314
4315,221325,3051,7480,0,3446,235302,221325,a,4315
4316,229239,3191,1991,0,732,235153,229239,a,4316
4317,5199,946,227824,0,889,234858,227824,g,4317
4318,225768,2460,4215,0,1230,233673,225768,a,4318
4319,4828,1303,4126,0,223195,233452,223195,t,4319
4320,4386,225213,1462,0,2030,233091,225213,c,4320
4321,219794,6060,3323,0,4525,233702,219794,a,4321
4322,2930,1955,227494,0,1647,234026,227494,g,4322
4323,1539,496,225989,0,6538,234562,225989,g,4323
4324,4059,219887,6031,0,2889,232866,219887,c,4324
4325,216414,5207,2716,0,1631,225968,216414,a,4325
4326,3256,823,220777,0,1194,226050,220777,g,4326
4327,216951,2823,4514,0,1494,225782,216951,a,4327
4328,2788,956,220889,0,1752,226385,220889,g,4328
4329,215920,3114,4378,0,1719,225131,215920,a,4329
4330,4317,949,5333,0,215765,226364,215765,t,4330
4331,219402,2069,3539,0,1333,226343,219402,a,4331
4332,3424,921,4063,0,222314,230722,222314,t,4332
4333,5304,223444,2170,0,2581,233499,223444,c,4333
4334,221493,4147,6224,0,3256,235120,221493,a,4334
4335,2133,787,230858,0,1667,235445,230858,g,4335
4336,2925,1438,223501,0,2866,230730,223501,g,4336
4337,222074,1581,5675,0,2132,231462,222074,a,4337
4338,225464,1900,2242,0,1359,230965,225464,a,4338
4339,5022,650,223032,0,1811,230515,223032,g,4339
4340,3376,219424,4690,0,1455,228945,219424,c,4340
4341,220179,3964,3323,0,6085,233551,220179,a,4341
4342,2060,1119,232283,0,540,236002,232283,g,4342
4343,3018,1395,5654,0,223733,233800,223733,t,4343
4344,3531,224021,4345,0,1351,233248,224021,c,4344
4345,2943,223573,4634,0,1436,232586,223573,c,4345
4346,223587,3787,2065,0,845,230284,223587,a,4346
4347,223991,1560,3736,0,417,229704,223991,a,4347
4348,3265,1053,2846,0,223042,230206,223042,t,4348
4349,3846,223843,1500,0,1671,230860,223843,c,4349
4350,1392,223281,4689,0,2203,231565,223281,c,4350
4351,1149,2615,3083,0,226527,233374,226527,t,4351
4352,709,480,231547,0,1221,233957,231547,g,4352
4353,2102,631,2996,0,225355,231084,225355,t,4353
4354,4274,223356,2404,0,961,230995,223356,c,4354
4355,223629,2432,4032,0,539,230632,223629,a,4355
4356,224636,1147,2896,0,1305,229984,224636,a,4356
4357,2482,787,3388,0,223619,230276,223619,t,4357
4358,225528,1971,1951,0,843,230293,225528,a,4358
4359,225699,959,2060,0,3056,231774,225699,a,4359
4360,4620,225706,1828,0,628,232782,225706,c,4360
4361,226450,1987,2591,0,622,231650,226450,a,4361
4362,228139,870,2237,0,907,232153,228139,a,4362
4363,3293,623,2698,0,226495,233109,226495,t,4363
4364,229310,1088,1881,0,832,233111,229310,a,4364
4365,2115,302,2384,0,229974,234775,229974,t,4365
4366,2315,230811,1443,0,5919,240488,230811,c,4366
4367,237264,2228,2353,0,2192,244037,237264,a,4367
4368,2049,578,240085,0,718,243430,240085,g,4368
4369,237955,1480,1108,0,1004,241547,237955,a,4369
4370,238306,1293,1234,0,827,241660,238306,a,4370
4371,3250,551,235826,0,476,240103,235826,g,4371
4372,235920,1274,980,0,1029,239203,235920,a,4372
4373,1408,892,1641,0,234540,238481,234540,t,4373
4374,659,763,235208,0,1402,238032,235208,g,4374
4375,469,182,236543,0,369,237563,236543,g,4375
4376,2372,886,2170,0,232281,237709,232281,t,4376
4377,235668,1032,627,0,545,237872,235668,a,4377
4378,1382,232,235637,0,1784,239035,235637,g,4378
4379,2640,232346,586,0,581,236153,232346,c,4379
4380,232469,1540,2320,0,2938,239267,232469,a,4380
4381,1279,921,792,0,240497,243489,240497,t,4381
4382,884,449,242341,0,864,244538,242341,g,4382
4383,686,799,993,0,242432,244910,242432,t,4383
4384,2321,241807,764,0,586,245478,241807,c,4384
4385,446,368,244237,0,410,245461,244237,g,4385
4386,238543,1415,2471,0,1763,244192,238543,a,4386
4387,1705,352,2424,0,241268,245749,241268,t,4387
4388,243242,915,1046,0,784,245987,243242,a,4388
4389,244011,909,681,0,794,246395,244011,a,4389
4390,244232,1081,968,0,448,246729,244232,a,4390
4391,242436,1399,2371,0,426,246632,242436,a,4391
4392,244018,1179,1047,0,310,246554,244018,a,4392
4393,241787,942,2406,0,2217,247352,241787,a,4393
4394,2872,242884,856,0,1320,247932,242884,c,4394
4395,2324,707,239861,0,473,243365,239861,g,4395
4396,236618,1499,2160,0,2309,242586,236618,a,4396
4397,239631,1794,754,0,460,242639,239631,a,4397
4398,2703,354,237107,0,2245,242409,237107,g,4398
4399,236830,2888,754,0,4333,244805,236830,a,4399
4400,989,292,244035,0,1892,247208,244035,g,4400
4401,897,655,244269,0,836,246657,244269,g,4401
4402,241509,1076,880,0,2248,245713,241509,a,4402
4403,242494,1380,1163,0,1634,246671,242494,a,4403
4404,3203,351,241101,0,2411,247066,241101,g,4404
4405,244042,878,1003,0,713,246636,244042,a,4405
4406,241237,944,3078,0,14629,259888,241237,a,4406
4407,2884,262519,1219,0,1338,267960,262519,c,4407
4408,264814,664,1567,0,452,267497,264814,a,4408
4409,264252,879,1099,0,863,267093,264252,a,4409
4410,264288,1347,761,0,1603,267999,264288,a,4410
4411,2668,261144,3355,0,965,268132,261144,c,4411
4412,255741,910,675,0,1518,258844,255741,a,4412
4413,1850,252786,3319,0,914,258869,252786,c,4413
4414,1370,875,3670,0,252141,258056,252141,t,4414
4415,1311,335,254517,0,1012,257175,254517,g,4415
4416,250741,989,882,0,2269,254881,250741,a,4416
4417,5939,246180,1040,0,1099,254258,246180,c,4417
4418,2101,238044,5772,0,493,246410,238044,c,4418
4419,242758,699,1360,0,512,245329,242758,a,4419
4420,1651,246,4759,0,238662,245318,238662,t,4420
4421,238090,4454,404,0,2442,245390,238090,a,4421
4422,1301,239407,4705,0,529,245942,239407,c,4422
4423,1079,476,1040,0,243115,245710,243115,t,4423
4424,1061,242405,1690,0,3447,248603,242405,c,4424
4425,242825,1040,5554,0,868,250287,242825,a,4425
4426,763,163,2275,0,246765,249966,246765,t,4426
4427,959,749,1114,0,247720,250542,247720,t,4427
4428,247605,792,1443,0,3590,253430,247605,a,4428
4429,705,180,252994,0,1122,255001,252994,g,4429
4430,247410,946,1916,0,1134,251406,247410,a,4430
4431,246349,636,2442,0,4475,253902,246349,a,4431
4432,2596,248497,2890,0,1212,255195,248497,c,4432
4433,241364,1165,1014,0,825,244368,241364,a,4433
4434,1381,402,241715,0,734,244232,241715,g,4434
4435,2011,752,239833,0,1668,244264,239833,g,4435
4436,238631,1230,2436,0,753,243050,238631,a,4436
4437,1904,744,2941,0,236133,241722,236133,t,4437
4438,3267,1603,962,0,235543,241375,235543,t,4438
4439,814,339,239223,0,1119,241495,239223,g,4439
4440,2278,235234,1671,0,2845,242028,235234,c,4440
4441,1422,433,1005,0,238715,241575,238715,t,4441
4442,485,1205,237262,0,1773,240725,237262,g,4442
4443,740,165,232438,0,2166,235509,232438,g,4443
4444,3961,612,947,0,230150,235670,230150,t,4444
4445,675,636,233584,0,699,235594,233584,g,4445
4446,231851,715,1716,0,877,235159,231851,a,4446
4447,681,245,1362,0,236015,238303,236015,t,4447
4448,1370,235300,1526,0,819,239015,235300,c,4448
4449,565,320,2775,0,237372,241032,237372,t,4449
4450,2059,237230,1298,0,1460,242047,237230,c,4450
4451,237953,1030,2215,0,2909,244107,237953,a,4451
4452,2067,268,241405,0,1084,244824,241405,g,4452
4453,1500,216,236388,0,1236,239340,236388,g,4453
4454,233880,1112,1085,0,2543,238620,233880,a,4454
4455,1431,233957,2653,0,682,238723,233957,c,4455
4456,1468,640,1145,0,234757,238010,234757,t,4456
4457,353,409,2374,0,234784,237920,234784,t,4457
4458,398,1655,600,0,235066,237719,235066,t,4458
4459,450,258,2187,0,233871,236766,233871,t,4459
4460,389,184,501,0,236466,237540,236466,t,4460
4461,1196,235795,497,0,554,238042,235795,c,4461
4462,816,234652,2134,0,571,238173,234652,c,4462
4463,371,184,507,0,236632,237694,236632,t,4463
4464,267,263,236422,0,571,237523,236422,g,4464
4465,828,278,384,0,236213,237703,236213,t,4465
4466,235328,641,258,0,613,236840,235328,a,4466
4467,625,273,1251,0,234786,236935,234786,t,4467
4468,1017,234124,1249,0,431,236821,234124,c,4468
4469,234745,565,784,0,493,236587,234745,a,4469
4470,234550,698,610,0,1146,237004,234550,a,4470
4471,472,221,848,0,236065,237606,236065,t,4471
4472,234904,630,904,0,1416,237854,234904,a,4472
4473,711,234728,850,0,7983,244272,234728,c,4473
4474,1678,244753,385,0,4058,250874,244753,c,4474
4475,249937,299,1083,0,2410,253729,249937,a,4475
4476,252861,822,308,0,315,254306,252861,a,4476
4477,364,125,466,0,254478,255433,254478,t,4477
4478,1281,253128,296,0,404,255109,253128,c,4478
4479,251479,630,473,0,1918,254500,251479,a,4479
4480,659,253490,511,0,961,255621,253490,c,4480
4481,624,163,253762,0,478,255027,253762,g,4481
4482,854,177,252010,0,1209,254250,252010,g,4482
4483,1896,248177,1010,0,868,251951,248177,c,4483
4484,248417,1184,1217,0,630,251448,248417,a,4484
4485,690,221,249632,0,2536,253079,249632,g,4485
4486,1567,250213,699,0,787,253266,250213,c,4486
4487,251264,964,1007,0,961,254196,251264,a,4487
4488,446,221,253130,0,1031,254828,253130,g,4488
4489,1629,251149,608,0,791,254177,251149,c,4489
4490,250967,1276,1299,0,672,254214,250967,a,4490
4491,738,441,1244,0,252941,255364,252941,t,4491
4492,506,1400,253124,0,708,255738,253124,g,4492
4493,698,705,252794,0,384,254581,252794,g,4493
4494,1510,581,1619,0,249572,253282,249572,t,4494
4495,248680,811,824,0,2751,253066,248680,a,4495
4496,972,250461,629,0,1442,253504,250461,c,4496
4497,1994,246581,2984,0,527,252086,246581,c,4497
4498,552,374,1309,0,250169,252404,250169,t,4498
4499,1067,360,250312,0,2359,254098,250312,g,4499
4500,1025,600,740,0,253112,255477,253112,t,4500
4501,923,1635,252603,0,748,255909,252603,g,4501
4502,1288,484,250364,0,674,252810,250364,g,4502
4503,1231,264,248400,0,570,250465,248400,g,4503
4504,242743,1761,1081,0,1005,246590,242743,a,4504
4505,241441,1638,1096,0,1898,246073,241441,a,4505
4506,1359,1578,242491,0,1391,246819,242491,g,4506
4507,2469,931,1916,0,242786,248102,242786,t,4507
4508,329,228,248084,0,857,249498,248084,g,4508
4509,243092,1379,752,0,3995,249218,243092,a,4509
4510,246041,1390,1044,0,3130,251605,246041,a,4510
4511,1162,266,249081,0,2220,252729,249081,g,4511
4512,242444,1089,1666,0,529,245728,242444,a,4512
4513,240066,1198,1513,0,1578,244355,240066,a,4513
4514,239033,1720,1938,0,2663,245354,239033,a,4514
4515,1497,239629,3288,0,1864,246278,239629,c,4515
4516,236017,1332,2565,0,753,240667,236017,a,4516
4517,227818,1017,3178,0,4403,236416,227818,a,4517
4518,2310,231988,884,0,1112,236294,231988,c,4518
4519,2597,467,225334,0,1770,230168,225334,g,4519
4520,1803,741,223824,0,3078,229446,223824,g,4520
4521,4494,1327,221163,0,3589,230573,221163,g,4521
4522,4407,220285,1893,0,3365,229950,220285,c,4522
4523,3420,2261,2372,0,221002,229055,221002,t,4523
4524,3256,1002,223473,0,510,228241,223473,g,4524
4525,544,328,224973,0,1096,226941,224973,g,4525
4526,219148,4190,1142,0,1014,225494,219148,a,4526
4527,1878,319,222720,0,291,225208,222720,g,4527
4528,2686,1326,1843,0,217191,223046,217191,t,4528
4529,215761,4209,2179,0,563,222712,215761,a,4529
4530,642,396,5662,0,215367,222067,215367,t,4530
4531,1954,1618,542,0,223774,227888,223774,t,4531
4532,425,1024,229091,0,1111,231651,229091,g,4532
4533,1695,741,577,0,225659,228672,225659,t,4533
4534,1597,2072,225011,0,1112,229792,225011,g,4534
4535,2365,251,221538,0,1370,225524,221538,g,4535
4536,819,220,219603,0,596,221238,219603,g,4536
4537,216748,1484,688,0,2872,221792,216748,a,4537
4538,2513,510,1640,0,218301,222964,218301,t,4538
4539,839,1779,218985,0,244,221847,218985,g,4539
4540,1484,322,868,0,218803,221477,218803,t,4540
4541,2395,216488,1670,0,1182,221735,216488,c,4541
4542,1261,214887,3161,0,6015,225324,214887,c,4542
4543,1546,223943,1984,0,1015,228488,223943,c,4543
4544,869,361,2366,0,223137,226733,223137,t,4544
4545,763,497,2236,0,222661,226157,222661,t,4545
4546,2583,221092,1410,0,383,225468,221092,c,4546
4547,222307,843,990,0,847,224987,222307,a,4547
4548,1192,220297,2346,0,791,224626,220297,c,4548
4549,2777,219637,1040,0,710,224164,219637,c,4549
4550,1441,219495,2353,0,447,223736,219495,c,4550
4551,1233,220889,635,0,467,223224,220889,c,4551
4552,1543,218812,2122,0,217,222694,218812,c,4552
4553,219136,912,676,0,1828,222552,219136,a,4553
4554,1354,220183,525,0,476,222538,220183,c,4554
4555,1341,218285,2079,0,647,222352,218285,c,4555
4556,1377,218881,448,0,2473,223179,218881,c,4556
4557,427,160,222631,0,403,223621,222631,g,4557
4558,1306,719,486,0,223871,226382,223871,t,4558
4559,439,461,226849,0,1633,229382,226849,g,4559
4560,379,159,228453,0,2840,231831,228453,g,4560
4561,574,176,231707,0,750,233207,231707,g,4561
4562,231611,916,359,0,204,233090,231611,a,4562
4563,231075,1411,220,0,430,233136,231075,a,4563
4564,230524,1656,459,0,1123,233762,230524,a,4564
4565,849,289,232706,0,1705,235549,232706,g,4565
4566,1536,292,231583,0,4046,237457,231583,g,4566
4567,1220,234933,1307,0,1059,238519,234933,c,4567
4568,2573,392,836,0,231978,235779,231978,t,4568
4569,471,127,234602,0,304,235504,234602,g,4569
4570,231492,1237,456,0,1165,234350,231492,a,4570
4571,230048,1143,476,0,4048,235715,230048,a,4571
4572,1301,233064,1071,0,1182,236618,233064,c,4572
4573,828,1182,882,0,234245,237137,234245,t,4573
4574,230,708,239339,0,528,240805,239339,g,4574
4575,872,335,238770,0,317,240294,238770,g,4575
4576,235349,1414,793,0,826,238382,235349,a,4576
4577,234356,1525,852,0,642,237375,234356,a,4577
4578,688,291,234693,0,614,236286,234693,g,4578
4579,232168,1511,869,0,553,235101,232168,a,4579
4580,775,1417,1670,0,231758,235620,231758,t,4580
4581,1264,1204,232007,0,416,234891,232007,g,4581
4582,1179,423,229632,0,2067,233301,229632,g,4582
4583,221345,2405,687,0,953,225390,221345,a,4583
4584,970,490,221983,0,1098,224541,221983,g,4584
4585,3432,208028,2022,0,2229,215711,208028,c,4585
4586,2193,202710,7114,0,3256,215273,202710,c,4586
4587,2891,1104,2536,0,211837,218368,211837,t,4587
4588,213948,1364,3201,0,752,219265,213948,a,4588
4589,1980,869,4210,0,212031,219090,212031,t,4589
4590,215091,1271,1715,0,953,219030,215091,a,4590
4591,685,345,217860,0,1373,220263,217860,g,4591
4592,212351,3904,1359,0,1197,218811,212351,a,4592
4593,211317,1697,5269,0,700,218983,211317,a,4593
4594,1565,899,1054,0,214695,218213,214695,t,4594
4595,1743,212684,1900,0,631,216958,212684,c,4595
4596,210526,1482,3073,0,1379,216460,210526,a,4596
4597,206736,2194,3695,0,2128,214753,206736,a,4597
4598,501,423,213043,0,3178,217145,213043,g,4598
4599,4018,195909,4034,0,1876,205837,195909,c,4599
4600,197427,1024,3888,0,1167,203506,197427,a,4600
4601,198760,1508,2661,0,819,203748,198760,a,4601
4602,196863,1325,4006,0,1505,203699,196863,a,4602
4603,197088,1424,3455,0,1654,203621,197088,a,4603
4604,198875,1784,1142,0,1431,203232,198875,a,4604
4605,732,1170,200645,0,1157,203704,200645,g,4605
4606,3746,555,195809,0,2396,202506,195809,g,4606
4607,605,298,197982,0,929,199814,197982,g,4607
4608,192582,3764,1390,0,1308,199044,192582,a,4608
4609,2874,459,3516,0,191169,198018,191169,t,4609
4610,650,676,739,0,204282,206347,204282,t,4610
4611,1285,207259,1150,0,608,210302,207259,c,4611
4612,461,331,3346,0,207021,211159,207021,t,4612
4613,965,2176,428,0,209183,212752,209183,t,4613
4614,355,262,212223,0,618,213458,212223,g,4614
4615,385,150,211205,0,1464,213204,211205,g,4615
4616,209016,961,1274,0,1253,212504,209016,a,4616
4617,1829,314,2357,0,207918,212418,207918,t,4617
4618,209151,796,1608,0,452,212007,209151,a,4618
4619,658,171,2283,0,208544,211656,208544,t,4619
4620,1211,616,1416,0,213245,216488,213245,t,4620
4621,1502,214184,1327,0,1746,218759,214184,c,4621
4622,2334,215286,1003,0,933,219556,215286,c,4622
4623,1761,214657,1090,0,913,218421,214657,c,4623
4624,216296,914,335,0,530,218075,216296,a,4624
4625,443,151,215851,0,851,217296,215851,g,4625
4626,214035,1388,536,0,529,216488,214035,a,4626
4627,464,289,860,0,215794,217407,215794,t,4627
4628,957,215204,395,0,877,217433,215204,c,4628
4629,629,227,215277,0,408,216541,215277,g,4629
4630,964,435,213407,0,797,215603,213407,g,4630
4631,211533,1541,820,0,1830,215724,211533,a,4631
4632,1730,388,212671,0,4445,219234,212671,g,4632
4633,2086,203535,1229,0,3293,210143,203535,c,4633
4634,1329,207622,681,0,1512,211144,207622,c,4634
4635,467,281,210046,0,304,211098,210046,g,4635
4636,689,224,207854,0,1492,210259,207854,g,4636
4637,201653,2778,599,0,1310,206340,201653,a,4637
4638,746,282,204905,0,928,206861,204905,g,4638
4639,1940,832,723,0,203104,206599,203104,t,4639
4640,727,527,4415,0,201129,206798,201129,t,4640
4641,507,1162,838,0,204038,206545,204038,t,4641
4642,203476,725,1428,0,4186,209815,203476,a,4642
4643,1601,204150,4875,0,1308,211934,204150,c,4643
4644,206859,993,606,0,347,208805,206859,a,4644
4645,205256,920,1342,0,603,208121,205256,a,4645
4646,205225,1296,692,0,1002,208215,205225,a,4646
4647,1513,251,205600,0,935,208299,205600,g,4647
4648,204176,1167,816,0,985,207144,204176,a,4648
4649,201571,1238,3768,0,4204,210781,201571,a,4649
4650,965,293,206860,0,4816,212934,206860,g,4650
4651,609,246,208675,0,504,210034,208675,g,4651
4652,204481,822,885,0,3290,209478,204481,a,4652
4653,206894,889,950,0,487,209220,206894,a,4653
4654,1676,202847,4104,0,1295,209922,202847,c,4654
4655,206639,980,914,0,483,209016,206639,a,4655
4656,435,207,1741,0,206645,209028,206645,t,4656
4657,789,2346,441,0,205331,208907,205331,t,4657
4658,1374,203497,1824,0,2599,209294,203497,c,4658
4659,1718,204376,1620,0,3162,210876,204376,c,4659
4660,206456,811,3383,0,571,211221,206456,a,4660
4661,776,217,1761,0,207536,210290,207536,t,4661
4662,206811,930,1201,0,1508,210450,206811,a,4662
4663,1258,206441,2209,0,722,210630,206441,c,4663
4664,208599,556,637,0,729,210521,208599,a,4664
4665,207382,1324,1027,0,694,210427,207382,a,4665
4666,1314,717,641,0,209163,211835,209163,t,4666
4667,770,363,210295,0,984,212412,210295,g,4667
4668,1597,840,698,0,210401,213536,210401,t,4668
4669,828,386,212025,0,1777,215016,212025,g,4669
4670,688,279,212793,0,1094,214854,212793,g,4670
4671,1605,209256,965,0,799,212625,209256,c,4671
4672,208081,1200,585,0,707,210573,208081,a,4672
4673,682,227,1275,0,212051,214235,212051,t,4673
4674,1194,809,211424,0,799,214226,211424,g,4674
4675,580,322,1004,0,213032,214938,213032,t,4675
4676,1979,211804,694,0,542,215019,211804,c,4676
4677,210901,2666,878,0,1065,215510,210901,a,4677
4678,2823,211179,750,0,285,215037,211179,c,4678
4679,210045,1465,1096,0,1254,213860,210045,a,4679
4680,3446,209621,513,0,408,213988,209621,c,4680
4681,745,584,211039,0,1152,213520,211039,g,4681
4682,1850,210546,471,0,593,213460,210546,c,4682
4683,1333,1264,209905,0,448,212950,209905,g,4683
4684,1709,473,206390,0,2574,211146,206390,g,4684
4685,3366,204129,845,0,855,209195,204129,c,4685
4686,1502,1026,201842,0,1349,205719,201842,g,4686
4687,2619,199678,1146,0,1355,204798,199678,c,4687
4688,1907,1126,1693,0,202327,207053,202327,t,4688
4689,742,729,204955,0,1479,207905,204955,g,4689
4690,2803,1138,2232,0,201634,207807,201634,t,4690
4691,1889,527,1604,0,204601,208621,204601,t,4691
4692,2400,203090,2459,0,685,208634,203090,c,4692
4693,2152,466,2179,0,203903,208700,203903,t,4693
4694,204819,1582,1352,0,546,208299,204819,a,4694
4695,203640,1635,2355,0,340,207970,203640,a,4695
4696,2510,868,1432,0,203099,207909,203099,t,4696
4697,776,551,204600,0,1395,207322,204600,g,4697
4698,2159,202741,1110,0,719,206729,202741,c,4698
4699,199768,2502,3338,0,484,206092,199768,a,4699
4700,1316,382,1322,0,202307,205327,202307,t,4700
4701,198770,1736,1464,0,2051,204021,198770,a,4701
4702,200067,1458,1032,0,1306,203863,200067,a,4702
4703,198540,1837,2766,0,1045,204188,198540,a,4703
4704,1403,459,201962,0,571,204395,201962,g,4704
4705,856,393,201683,0,735,203667,201683,g,4705
4706,198632,1564,1390,0,550,202136,198632,a,4706
4707,199306,1177,846,0,2556,203885,199306,a,4707
4708,201744,1175,403,0,765,204087,201744,a,4708
4709,1958,405,200681,0,593,203637,200681,g,4709
4710,190584,1905,715,0,744,193948,190584,a,4710
4711,1032,401,190052,0,2074,193559,190052,g,4711
4712,2409,651,188725,0,4817,196602,188725,g,4712
4713,190272,1587,3273,0,2174,197306,190272,a,4713
4714,1249,2161,1608,0,192932,197950,192932,t,4714
4715,3042,2077,2313,0,191809,199241,191809,t,4715
4716,971,231,198007,0,1229,200438,198007,g,4716
4717,195644,1375,2180,0,676,199875,195644,a,4717
4718,196312,750,718,0,2764,200544,196312,a,4718
4719,4464,193006,2434,0,989,200893,193006,c,4719
4720,2328,189429,3060,0,1240,196057,189429,c,4720
4721,190244,2285,2831,0,489,195849,190244,a,4721
4722,1409,766,2268,0,191891,196334,191891,t,4722
4723,1724,192930,1611,0,493,196758,192930,c,4723
4724,187294,2561,4709,0,840,195404,187294,a,4724
4725,3281,888,1395,0,186902,192466,186902,t,4725
4726,1022,1116,188808,0,1379,192325,188808,g,4726
4727,3514,813,185932,0,2830,193089,185932,g,4727
4728,2744,543,186488,0,3268,193043,186488,g,4728
4729,2448,185765,2395,0,1771,192379,185765,c,4729
4730,1872,716,187352,0,391,190331,187352,g,4730
4731,1028,533,185631,0,1390,188582,185631,g,4731
4732,179299,2678,1120,0,1856,184953,179299,a,4732
4733,2870,179254,1777,0,1887,185788,179254,c,4733
4734,1031,630,180228,0,961,182850,180228,g,4734
4735,1460,484,2568,0,178232,182744,178232,t,4735
4736,1715,777,3271,0,176985,182748,176985,t,4736
4737,177313,1408,1233,0,2971,182925,177313,a,4737
4738,178440,1215,2381,0,4419,186455,178440,a,4738
4739,920,181,186983,0,582,188666,186983,g,4739
4740,182952,1282,978,0,954,186166,182952,a,4740
4741,181892,849,2038,0,824,185603,181892,a,4741
4742,181844,1628,945,0,765,185182,181844,a,4742
4743,2474,303,179875,0,914,183566,179875,g,4743
4744,176056,1124,1009,0,2361,180550,176056,a,4744
4745,2201,173443,4003,0,2975,182622,173443,c,4745
4746,2599,171167,3870,0,2474,180110,171167,c,4746
4747,759,336,5517,0,173105,179717,173105,t,4747
4748,174803,1205,1204,0,2531,179743,174803,a,4748
4749,176457,954,1442,0,827,179680,176457,a,4749
4750,1751,683,5165,0,172187,179786,172187,t,4750
4751,174550,1400,1443,0,448,177841,174550,a,4751
4752,1172,311,3596,0,172272,177351,172272,t,4752
4753,2318,173288,1085,0,822,177513,173288,c,4753
4754,169913,1803,3633,0,1443,176792,169913,a,4754
4755,1226,1014,1831,0,172203,176274,172203,t,4755
4756,169316,2128,2632,0,1062,175138,169316,a,4756
4757,881,1349,2442,0,172028,176700,172028,t,4757
4758,1672,696,172723,0,875,175966,172723,g,4758
4759,724,235,172426,0,1846,175231,172426,g,4759
4760,169475,1530,1574,0,4074,176653,169475,a,4760
4761,2309,848,172996,0,685,176838,172996,g,4761
4762,1330,337,172376,0,737,174780,172376,g,4762
4763,170550,1633,690,0,1429,174302,170550,a,4763
4764,1796,744,171353,0,1225,175118,171353,g,4764
4765,2462,1062,167872,0,6358,177754,167872,g,4765
4766,2614,173564,2633,0,1427,180238,173564,c,4766
4767,777,1432,1255,0,177034,180498,177034,t,4767
4768,669,1019,179132,0,775,181595,179132,g,4768
4769,683,179,178681,0,1192,180735,178681,g,4769
4770,175298,1149,741,0,1513,178701,175298,a,4770
4771,175990,1205,1231,0,1241,179667,175990,a,4771
4772,1104,329,175923,0,2526,179882,175923,g,4772
4773,3329,174346,1306,0,792,179773,174346,c,4773
4774,621,532,2075,0,175619,178847,175619,t,4774
4775,174068,2845,1035,0,981,178929,174068,a,4775
4776,705,202,177309,0,581,178797,177309,g,4776
4777,169212,1288,1769,0,1119,173388,169212,a,4777
4778,169111,1609,1370,0,6779,178869,169111,a,4778
4779,2221,621,178336,0,657,181835,178336,g,4779
4780,983,528,178589,0,842,180942,178589,g,4780
4781,176709,1422,1282,0,1192,180605,176709,a,4781
4782,1132,434,178247,0,961,180774,178247,g,4782
4783,170821,2589,1689,0,1429,176528,170821,a,4783
4784,169222,1138,3220,0,1338,174918,169222,a,4784
4785,852,1730,1169,0,170859,174610,170859,t,4785
4786,1226,843,171663,0,674,174406,171663,g,4786
4787,697,245,170089,0,2572,173603,170089,g,4787
4788,169435,1537,516,0,929,172417,169435,a,4788
4789,167175,1540,2659,0,1899,173273,167175,a,4789
4790,1965,601,167573,0,1168,171307,167573,g,4790
4791,1920,332,163849,0,1099,167200,163849,g,4791
4792,161638,979,1944,0,3047,167608,161638,a,4792
4793,164365,1394,972,0,2862,169593,164365,a,4793
4794,2816,704,165823,0,1782,171125,165823,g,4794
4795,843,995,160028,0,2245,164111,160028,g,4795
4796,157221,1234,4098,0,7082,169635,157221,a,4796
4797,2049,395,169826,0,5467,177737,169826,g,4797
4798,171669,1725,728,0,2907,177029,171669,a,4798
4799,172248,1025,3260,0,1132,177665,172248,a,4799
4800,3100,318,172376,0,1722,177516,172376,g,4800
4801,171177,1070,2570,0,804,175621,171177,a,4801
4802,170152,2056,2799,0,3246,178253,170152,a,4802
4803,2213,1169,175345,0,1395,180122,175345,g,4803
4804,2213,526,2374,0,176058,181171,176058,t,4804
4805,1782,173482,5433,0,2964,183661,173482,c,4805
4806,2006,174602,2440,0,5081,184129,174602,c,4806
4807,178824,1625,1250,0,1705,183404,178824,a,4807
4808,988,1055,179512,0,1454,183009,179512,g,4808
4809,4981,358,175222,0,442,181003,175222,g,4809
4810,1623,644,2859,0,175496,180622,175496,t,4810
4811,2414,174376,2421,0,792,180003,174376,c,4811
4812,1032,249,2268,0,176975,180524,176975,t,4812
4813,2132,3557,851,0,175433,181973,175433,t,4813
4814,494,1070,180427,0,666,182657,180427,g,4814
4815,1162,239,180670,0,719,182790,180670,g,4815
4816,2119,175318,2301,0,3691,183429,175318,c,4816
4817,179914,1048,2236,0,357,183555,179914,a,4817
4818,949,269,3402,0,179259,183879,179259,t,4818
4819,1663,903,999,0,181715,185280,181715,t,4819
4820,1199,1194,183069,0,426,185888,183069,g,4820
4821,658,578,182805,0,1135,185176,182805,g,4821
4822,181253,1416,966,0,1252,184887,181253,a,4822
4823,1018,452,182351,0,1478,185299,182351,g,4823
4824,1629,181426,727,0,1672,185454,181426,c,4824
4825,1708,181809,1412,0,807,185736,181809,c,4825
4826,530,657,1171,0,184721,187079,184721,t,4826
4827,557,231,186552,0,1227,188567,186552,g,4827
4828,10829,172,177013,0,9688,197702,177013,g,4828
4829,199865,720,663,0,1641,202889,199865,a,4829
4830,201850,622,642,0,664,203778,201850,a,4830
4831,202418,593,528,0,351,203890,202418,a,4831
4832,202005,641,686,0,402,203734,202005,a,4832
4833,201299,860,703,0,481,203343,201299,a,4833
4834,201675,744,583,0,222,203224,201675,a,4834
4835,377,210,674,0,202902,204163,202902,t,4835
4836,991,202031,625,0,1615,205262,202031,c,4836
4837,1346,202999,824,0,732,205901,202999,c,4837
4838,204159,558,324,0,402,205443,204159,a,4838
4839,203435,943,508,0,1275,206161,203435,a,4839
4840,985,189,205063,0,535,206772,205063,g,4840
4841,204602,714,316,0,1443,207075,204602,a,4841
4842,1050,380,205427,0,574,207431,205427,g,4842
4843,1228,204391,365,0,683,206667,204391,c,4843
4844,1357,204506,343,0,4702,210908,204506,c,4844
4845,385,247,211640,0,915,213187,211640,g,4845
4846,815,471,531,0,211358,213175,211358,t,4846
4847,1233,211238,625,0,798,213894,211238,c,4847
4848,1448,211188,663,0,879,214178,211188,c,4848
4849,212861,679,464,0,2159,216163,212861,a,4849
4850,214660,1007,504,0,2897,219068,214660,a,4850
4851,218342,845,467,0,6783,226437,218342,a,4851
4852,920,227661,772,0,2584,231937,227661,c,4852
4853,231704,610,208,0,440,232962,231704,a,4853
4854,231694,762,488,0,342,233286,231694,a,4854
4855,231722,896,351,0,494,233463,231722,a,4855
4856,231497,844,664,0,1069,234074,231497,a,4856
4857,1170,232259,288,0,2480,236197,232259,c,4857
4858,1162,234412,512,0,487,236573,234412,c,4858
4859,404,253,488,0,235803,236948,235803,t,4859
4860,236,385,235792,0,2621,239034,235792,g,4860
4861,401,118,238430,0,429,239378,238430,g,4861
4862,754,368,449,0,238085,239656,238085,t,4862
4863,1034,237802,596,0,535,239967,237802,c,4863
4864,342,207,548,0,238883,239980,238883,t,4864
4865,286,242,300,0,241865,242693,241865,t,4865
4866,205,286,563,0,243528,244582,243528,t,4866
4867,229,91,521,0,245200,246041,245200,t,4867
4868,1025,244687,540,0,587,246839,244687,c,4868
4869,245202,486,290,0,343,246321,245202,a,4869
4870,244551,754,467,0,326,246098,244551,a,4870
4871,244318,911,483,0,268,245980,244318,a,4871
4872,244166,582,388,0,645,245781,244166,a,4872
4873,1465,243289,356,0,1009,246119,243289,c,4873
4874,1763,240274,850,0,543,243430,240274,c,4874
4875,241869,448,590,0,195,243102,241869,a,4875
4876,240591,494,634,0,792,242511,240591,a,4876
4877,1184,240603,313,0,1255,243355,240603,c,4877
4878,1743,487,237017,0,3572,242819,237017,g,4878
4879,1273,240258,534,0,5592,247657,240258,c,4879
4880,1437,246805,429,0,757,249428,246805,c,4880
4881,834,256,247372,0,600,249062,247372,g,4881
4882,600,214,246617,0,586,248017,246617,g,4882
4883,241452,1020,387,0,520,243379,241452,a,4883
4884,240686,1205,773,0,818,243482,240686,a,4884
4885,1380,239026,1263,0,3978,245647,239026,c,4885
4886,1338,242678,1333,0,942,246291,242678,c,4886
4887,242287,1182,2176,0,532,246177,242287,a,4887
4888,1103,290,1606,0,243541,246540,243541,t,4888
4889,243817,1483,224,0,695,246219,243817,a,4889
4890,1754,340,243204,0,2163,247461,243204,g,4890
4891,894,319,245473,0,419,247105,245473,g,4891
4892,3612,1771,1116,0,245336,251835,245336,t,4892
4893,1136,611,251237,0,1622,254606,251237,g,4893
4894,1591,250147,886,0,3818,256442,250147,c,4894
4895,1799,253121,1044,0,1384,257348,253121,c,4895
4896,999,237,253361,0,2016,256613,253361,g,4896
4897,1720,1022,1446,0,250486,254674,250486,t,4897
4898,252108,929,1236,0,341,254614,252108,a,4898
4899,988,259,1071,0,253416,255734,253416,t,4899
4900,1761,252486,1523,0,736,256506,252486,c,4900
4901,974,548,1469,0,258471,261462,258471,t,4901
4902,2040,257802,1468,0,1797,263107,257802,c,4902
4903,1263,892,1826,0,260548,264529,260548,t,4903
4904,1470,342,261236,0,868,263916,261236,g,4904
4905,1045,213,254181,0,779,256218,254181,g,4905
4906,250941,1609,881,0,2664,256095,250941,a,4906
4907,3348,249037,2431,0,997,255813,249037,c,4907
4908,1491,1020,2381,0,248642,253534,248642,t,4908
4909,1756,571,2096,0,248686,253109,248686,t,4909
4910,888,765,2216,0,248793,252662,248793,t,4910
4911,602,1905,1002,0,248872,252381,248872,t,4911
4912,1217,247020,2392,0,870,251499,247020,c,4912
4913,663,251,915,0,248642,250471,248642,t,4913
4914,1165,247414,743,0,3064,252386,247414,c,4914
4915,1353,247429,2550,0,1123,252455,247429,c,4915
4916,684,335,926,0,250520,252465,250520,t,4916
4917,347,270,251663,0,411,252691,251663,g,4917
4918,559,327,250243,0,1072,252201,250243,g,4918
4919,249378,1234,604,0,286,251502,249378,a,4919
4920,248456,1020,1368,0,769,251613,248456,a,4920
4921,1985,247866,984,0,2667,253502,247866,c,4921
4922,1044,250116,2399,0,942,254501,250116,c,4922
4923,1555,321,533,0,253514,255923,253514,t,4923
4924,1278,253063,1543,0,3068,258952,253063,c,4924
4925,256776,1272,524,0,2517,261089,256776,a,4925
4926,1222,333,258888,0,1023,261466,258888,g,4926
4927,827,307,258486,0,1101,260721,258486,g,4927
4928,257682,1412,594,0,543,260231,257682,a,4928
4929,695,250,761,0,264348,266054,264348,t,4929
4930,1174,265566,451,0,1395,268586,265566,c,4930
4931,401,308,603,0,267300,268612,267300,t,4931
4932,1170,266112,472,0,3416,271170,266112,c,4932
4933,1380,268662,1243,0,404,271689,268662,c,4933
4934,266728,660,1251,0,510,269149,266728,a,4934
4935,262177,1453,526,0,501,264657,262177,a,4935
4936,658,196,685,0,263685,265224,263685,t,4936
4937,967,261099,1485,0,840,264391,261099,c,4937
4938,261482,1077,533,0,549,263641,261482,a,4938
4939,299,638,1833,0,259612,262382,259612,t,4939
4940,694,261123,275,0,689,262781,261123,c,4940
4941,356,259,260461,0,448,261524,260461,g,4941
4942,249225,1380,1564,0,5217,257386,249225,a,4942
4943,2302,254190,2092,0,1424,260008,254190,c,4943
4944,252664,1182,2156,0,720,256722,252664,a,4944
4945,252121,1343,1810,0,2379,257653,252121,a,4945
4946,252190,1879,2751,0,336,257156,252190,a,4946
4947,250530,1693,2553,0,2261,257037,250530,a,4947
4948,252801,2032,741,0,1575,257149,252801,a,4948
4949,251393,2322,2663,0,3574,259952,251393,a,4949
4950,635,400,260231,0,2291,263557,260231,g,4950
4951,513,308,261264,0,899,262984,261264,g,4951
4952,258074,1794,2327,0,785,262980,258074,a,4952
4953,259477,1971,590,0,1047,263085,259477,a,4953
4954,258097,2691,1563,0,544,262895,258097,a,4954
4955,256660,2731,2545,0,1207,263143,256660,a,4955
4956,1984,457,260336,0,392,263169,260336,g,4956
4957,2712,828,3473,0,254991,262004,254991,t,4957
4958,1365,802,891,0,259754,262812,259754,t,4958
4959,549,316,260900,0,1589,263354,260900,g,4959
4960,3576,1185,701,0,253554,259016,253554,t,4960
4961,4051,627,250934,0,952,256564,250934,g,4961
4962,2347,4413,236456,0,1367,244583,236456,g,4962
4963,4236,374,238592,0,550,243752,238592,g,4963
4964,1795,549,684,0,241886,244914,241886,t,4964
4965,1315,241659,341,0,1969,245284,241659,c,4965
4966,467,845,2327,0,239875,243514,239875,t,4966
4967,613,2055,5447,0,234595,242710,234595,t,4967
4968,703,286,3391,0,237241,241621,237241,t,4968
4969,237600,1101,2066,0,1478,242245,237600,a,4969
4970,1186,264,5327,0,234648,241425,234648,t,4970
4971,623,1276,237724,0,681,240304,237724,g,4971
4972,906,209,237582,0,505,239202,237582,g,4972
4973,5619,1027,2584,0,229027,238257,229027,t,4973
4974,234349,2681,420,0,371,237821,234349,a,4974
4975,233707,1446,1811,0,1104,238068,233707,a,4975
4976,667,1158,5771,0,230633,238229,230633,t,4976
4977,5886,2057,229269,0,555,237767,229269,g,4977
4978,446,212,235718,0,804,237180,235718,g,4978
4979,1663,2220,873,0,233247,238003,233247,t,4979
4980,737,240,237033,0,601,238611,237033,g,4980
4981,721,382,378,0,236034,237515,236034,t,4981
4982,5101,2086,323,0,231546,239056,231546,t,4982
4983,742,301,237809,0,587,239439,237809,g,4983
4984,3589,342,1223,0,232852,238006,232852,t,4984
4985,633,478,1311,0,235318,237740,235318,t,4985
4986,232186,1992,699,0,2977,237854,232186,a,4986
4987,2038,233041,2339,0,1849,239267,233041,c,4987
4988,233282,1592,775,0,1157,236806,233282,a,4988
4989,230656,2001,1748,0,804,235209,230656,a,4989
4990,2870,392,231012,0,670,234944,231012,g,4990
4991,912,536,226786,0,1028,229262,226786,g,4991
4992,223933,1505,1253,0,2074,228765,223933,a,4992
4993,722,442,226570,0,1306,229040,226570,g,4993
4994,3074,3750,1073,0,219337,227234,219337,t,4994
4995,2443,778,222625,0,927,226773,222625,g,4995
4996,976,434,220811,0,4738,226959,220811,g,4996
4997,221192,1987,1021,0,3137,227337,221192,a,4997
4998,933,396,224079,0,5025,230433,224079,g,4998
4999,1695,221650,1113,0,2148,226606,221650,c,4999
5000,220900,777,4569,0,1358,227604,220900,a,5000
5001,637,563,2318,0,224225,227743,224225,t,5001
5002,223204,1929,1388,0,1777,228298,223204,a,5002
5003,1930,754,1687,0,225155,229526,225155,t,5003
5004,428,747,227538,0,973,229686,227538,g,5004
5005,2498,539,1599,0,225278,229914,225278,t,5005
5006,821,340,227527,0,1170,229858,227527,g,5006
5007,225349,2433,901,0,2023,230706,225349,a,5007
5008,482,170,229441,0,955,231048,229441,g,5008
5009,1715,704,1223,0,224683,228325,224683,t,5009
5010,356,1559,225528,0,1024,228467,225528,g,5010
5011,2912,219859,1968,0,1277,226016,219859,c,5011
5012,1172,287,947,0,224069,226475,224069,t,5012
5013,221624,757,2005,0,691,225077,221624,a,5013
5014,461,146,3181,0,220297,224085,220297,t,5014
5015,218424,738,263,0,751,220176,218424,a,5015
5016,477,194,216193,0,6189,223053,216193,g,5016
5017,2271,216333,1930,0,3118,223652,216333,c,5017
5018,2399,217775,2054,0,3621,225849,217775,c,5018
5019,2863,217462,1738,0,1662,223725,217462,c,5019
5020,217837,1464,1611,0,1813,222725,217837,a,5020
5021,745,233,220756,0,462,222196,220756,g,5021
5022,206104,889,466,0,2608,210067,206104,a,5022
5023,2105,203319,2991,0,1289,209704,203319,c,5023
5024,752,860,7029,0,202022,210663,202022,t,5024
5025,1925,230,208603,0,1036,211794,208603,g,5025
5026,205661,1071,3059,0,2449,212240,205661,a,5026
5027,210277,975,706,0,651,212609,210277,a,5027
5028,204838,937,5891,0,2473,214139,204838,a,5028
5029,211091,969,865,0,594,213519,211091,a,5029
5030,204626,863,7035,0,896,213420,204626,a,5030
5031,206295,6070,479,0,720,213564,206295,a,5031
5032,398,266,212346,0,608,213618,212346,g,5032
5033,2156,844,1398,0,207278,211676,207278,t,5033
5034,203836,5064,2629,0,806,212335,203836,a,5034
5035,383,424,5419,0,207403,213629,207403,t,5035
5036,1974,385,1459,0,210479,214297,210479,t,5036
5037,433,379,211958,0,1125,213895,211958,g,5037
5038,206618,865,612,0,9268,217363,206618,a,5038
5039,217048,1055,498,0,2537,221138,217048,a,5039
5040,897,1089,217359,0,711,220056,217359,g,5040
5041,199382,905,2736,0,1453,204476,199382,a,5041
5042,1646,192231,6485,0,692,201054,192231,c,5042
5043,193960,1910,4324,0,891,201085,193960,a,5043
5044,194804,690,4115,0,1159,200768,194804,a,5044
5045,1424,543,785,0,196464,199216,196464,t,5045
5046,1322,190682,3465,0,5036,200505,190682,c,5046
5047,3713,192886,4115,0,3028,203742,192886,c,5047
5048,197149,697,2730,0,887,201463,197149,a,5048
5049,2607,169,197590,0,473,200839,197590,g,5049
5050,187869,1057,923,0,928,190777,187869,a,5050
5051,666,160,186896,0,2449,190171,186896,g,5051
5052,183033,2528,2426,0,723,188710,183033,a,5052
5053,702,290,2049,0,189984,193025,189984,t,5053
5054,1044,193482,661,0,1575,196762,193482,c,5054
5055,495,189,195985,0,519,197188,195985,g,5055
5056,191985,878,1827,0,2122,196812,191985,a,5056
5057,192830,1496,1053,0,1377,196756,192830,a,5057
5058,484,266,194742,0,888,196380,194742,g,5058
5059,188813,973,1175,0,1341,192302,188813,a,5059
5060,742,1934,5057,0,184001,191734,184001,t,5060
5061,339,2174,187131,0,2082,191726,187131,g,5061
5062,183457,822,4104,0,3010,191393,183457,a,5062
5063,1206,2480,1265,0,187683,192634,187683,t,5063
5064,186512,2376,3501,0,858,193247,186512,a,5064
5065,739,260,3449,0,188609,193057,188609,t,5065
5066,2009,767,3582,0,186913,193271,186913,t,5066
5067,369,592,1482,0,190961,193404,190961,t,5067
5068,3050,1719,1183,0,187735,193687,187735,t,5068
5069,874,308,3154,0,192514,196850,192514,t,5069
5070,1108,192867,4011,0,1043,199029,192867,c,5070
5071,384,133,198477,0,414,199408,198477,g,5071
5072,195136,873,2423,0,617,199049,195136,a,5072
5073,195916,868,670,0,1795,199249,195916,a,5073
5074,196478,960,1163,0,949,199550,196478,a,5074
5075,576,243,198016,0,3856,202691,198016,g,5075
5076,201944,906,835,0,1257,204942,201944,a,5076
5077,572,317,203859,0,338,205086,203859,g,5077
5078,200420,679,839,0,2550,204488,200420,a,5078
5079,200866,775,2077,0,721,204439,200866,a,5079
5080,200019,776,1510,0,2874,205179,200019,a,5080
5081,202792,985,975,0,825,205577,202792,a,5081
5082,425,363,1066,0,204657,206511,204657,t,5082
5083,1324,827,297,0,204598,207046,204598,t,5083
5084,652,526,205277,0,784,207239,205277,g,5084
5085,202798,794,1421,0,2895,207908,202798,a,5085
5086,1444,204598,826,0,1905,208773,204598,c,5086
5087,1388,202558,2224,0,752,206922,202558,c,5087
5088,203684,461,1357,0,1259,206761,203684,a,5088
5089,473,877,682,0,207260,209292,207260,t,5089
5090,1353,207737,1055,0,1116,211261,207737,c,5090
5091,207255,753,1628,0,5065,214701,207255,a,5091
5092,777,990,517,0,213518,215802,213518,t,5092
5093,671,320,213505,0,570,215066,213505,g,5093
5094,829,244,213130,0,454,214657,213130,g,5094
5095,210373,1059,881,0,2257,214570,210373,a,5095
5096,2136,211106,877,0,1757,215876,211106,c,5096
5097,1965,211209,1993,0,629,215796,211209,c,5097
5098,1275,394,692,0,213387,215748,213387,t,5098
5099,1251,212380,1327,0,1165,216123,212380,c,5099
5100,1829,212844,1002,0,412,216087,212844,c,5100
5101,212348,805,1822,0,1069,216044,212348,a,5101
5102,1100,211407,891,0,1642,215040,211407,c,5102
5103,1709,210339,994,0,699,213741,210339,c,5103
5104,1422,208673,2223,0,703,213021,208673,c,5104
5105,209919,761,560,0,1549,212789,209919,a,5105
5106,1278,388,210478,0,801,212945,210478,g,5106
5107,578,332,209264,0,1691,211865,209264,g,5107
5108,204217,1197,1253,0,2320,208987,204217,a,5108
5109,703,340,206922,0,1922,209887,206922,g,5109
5110,1816,206723,436,0,1186,210161,206723,c,5110
5111,505,205,208615,0,2838,212163,208615,g,5111
5112,721,716,210014,0,1549,213000,210014,g,5112
5113,1452,298,207868,0,1077,210695,207868,g,5113
5114,203867,1146,2285,0,1276,208574,203867,a,5114
5115,202087,1632,2533,0,852,207104,202087,a,5115
5116,203944,1878,594,0,842,207258,203944,a,5116
5117,1019,294,204187,0,1623,207123,204187,g,5117
5118,200932,2295,827,0,14150,218204,200932,a,5118
5119,1469,220049,3131,0,2028,226677,220049,c,5119
5120,850,206,224055,0,822,225933,224055,g,5120
5121,217968,953,695,0,2860,222476,217968,a,5121
5122,217814,1533,1427,0,1626,222400,217814,a,5122
5123,1883,496,216965,0,1751,221095,216965,g,5123
5124,217293,1064,1185,0,1828,221370,217293,a,5124
5125,1164,273,218802,0,1311,221550,218802,g,5125
5126,214417,3450,1306,0,1456,220629,214417,a,5126
5127,1048,329,3496,0,215320,220193,215320,t,5127
5128,213355,1802,901,0,3204,219262,213355,a,5128
5129,1561,212882,2903,0,2068,219414,212882,c,5129
5130,2248,212461,2785,0,860,218354,212461,c,5130
5131,812,177,1919,0,214493,217401,214493,t,5131
5132,666,1123,1522,0,214141,217452,214141,t,5132
5133,2430,211692,724,0,2352,217198,211692,c,5133
5134,1939,211761,2724,0,746,217170,211761,c,5134
5135,1046,354,211948,0,1273,214621,211948,g,5135
5136,1392,429,209754,0,968,212543,209754,g,5136
5137,3596,201045,1093,0,1280,207014,201045,c,5137
5138,2838,199414,2558,0,928,205738,199414,c,5138
5139,202740,1054,1440,0,497,205731,202740,a,5139
5140,552,211,1865,0,203325,205953,203325,t,5140
5141,201516,3455,359,0,1743,207073,201516,a,5141
5142,553,318,206162,0,348,207381,206162,g,5142
5143,709,768,3233,0,204488,209198,204488,t,5143
5144,2357,204934,1771,0,2494,211556,204934,c,5144
5145,209486,1246,599,0,1004,212335,209486,a,5145
5146,1867,293,208743,0,1685,212588,208743,g,5146
5147,208072,1778,548,0,1070,211468,208072,a,5147
5148,688,427,209228,0,1524,211867,209228,g,5148
5149,204523,3146,375,0,1489,209533,204523,a,5149
5150,524,294,207253,0,910,208981,207253,g,5150
5151,772,461,204165,0,3309,208707,204165,g,5151
5152,1264,204309,2026,0,1857,209456,204309,c,5152
5153,792,827,1408,0,206518,209545,206518,t,5153
5154,205790,1116,1874,0,775,209555,205790,a,5154
5155,1058,219,2417,0,206503,210197,206503,t,5155
5156,208225,924,724,0,656,210529,208225,a,5156
5157,207063,690,1384,0,1807,210944,207063,a,5157
5158,208064,1688,802,0,316,210870,208064,a,5158
5159,206732,721,1249,0,5141,213843,206732,a,5159
5160,2210,211829,752,0,688,215479,211829,c,5160
5161,1986,918,208090,0,506,211500,208090,g,5161
5162,1911,1456,205961,0,1805,211133,205961,g,5162
5163,1134,859,206223,0,1450,209666,206223,g,5163
5164,1071,293,205806,0,2551,209721,205806,g,5164
5165,1801,205170,891,0,2075,209937,205170,c,5165
5166,1651,205562,2049,0,1037,210299,205562,c,5166
5167,803,438,1008,0,208620,210869,208620,t,5167
5168,949,406,209220,0,1338,211913,209220,g,5168
5169,208931,1659,858,0,3640,215088,208931,a,5169
5170,1205,376,214295,0,715,216591,214295,g,5170
5171,453,318,214709,0,448,215928,214709,g,5171
5172,212477,1415,888,0,6502,221282,212477,a,5172
5173,2331,219957,1100,0,2601,225989,219957,c,5173
5174,223330,2605,515,0,580,227030,223330,a,5174
5175,634,200,1206,0,225227,227267,225227,t,5175
5176,1030,336,695,0,225362,227423,225362,t,5176
5177,224685,1501,877,0,925,227988,224685,a,5177
5178,225532,1416,934,0,263,228145,225532,a,5178
5179,799,218,482,0,227492,228991,227492,t,5179
5180,1322,226601,570,0,1211,229704,226601,c,5180
5181,1257,226922,781,0,1065,230025,226922,c,5181
5182,912,780,288,0,227975,229955,227975,t,5182
5183,595,420,227843,0,615,229473,227843,g,5183
5184,678,447,227671,0,623,229419,227671,g,5184
5185,1493,226293,587,0,1114,229487,226293,c,5185
5186,1705,226900,594,0,463,229662,226900,c,5186
5187,1680,226360,621,0,527,229188,226360,c,5187
5188,1399,227026,477,0,1052,229954,227026,c,5188
5189,1423,227939,561,0,482,230405,227939,c,5189
5190,227798,1738,404,0,4631,234571,227798,a,5190
5191,1536,234184,548,0,957,237225,234184,c,5191
5192,611,493,547,0,235844,237495,235844,t,5192
5193,235000,1493,715,0,1218,238426,235000,a,5193
5194,1585,543,236309,0,1039,239476,236309,g,5194
5195,235637,2091,905,0,2859,241492,235637,a,5195
5196,1206,427,240636,0,544,242813,240636,g,5196
5197,1683,985,744,0,238202,241614,238202,t,5197
5198,1627,237894,758,0,995,241274,237894,c,5198
5199,810,466,238313,0,730,240319,238313,g,5199
5200,2034,1143,1494,0,235105,239776,235105,t,5200
5201,977,446,237479,0,974,239876,237479,g,5201
5202,7646,600,209145,0,1148,218539,209145,g,5202
5203,2099,204026,8150,0,958,215233,204026,c,5203
5204,208482,3355,1155,0,1188,214180,208482,a,5204
5205,1077,435,204421,0,10910,216843,204421,g,5205
5206,2030,213451,1054,0,1675,218210,213451,c,5206
5207,1068,937,8584,0,206717,217306,206717,t,5207
5208,488,733,215118,0,797,217136,215118,g,5208
5209,211573,2553,1477,0,1272,216875,211573,a,5209
5210,212620,2436,1047,0,985,217088,212620,a,5210
5211,206664,2002,7274,0,1229,217169,206664,a,5211
5212,2836,1230,2613,0,211312,217991,211312,t,5212
5213,1812,1843,213436,0,1055,218146,213436,g,5213
5214,1287,1304,211147,0,4639,218377,211147,g,5214
5215,210782,2604,2368,0,5200,220954,210782,a,5215
5216,2589,1139,216102,0,2296,222126,216102,g,5216
5217,1741,723,211143,0,2379,215986,211143,g,5217
5218,207141,2146,2286,0,2796,214369,207141,a,5218
5219,208217,1953,2434,0,1462,214066,208217,a,5219
5220,3312,665,208741,0,1228,213946,208741,g,5220
5221,7101,201705,3285,0,3699,215790,201705,c,5221
5222,2498,206691,4448,0,3078,216715,206691,c,5222
5223,2578,207149,2974,0,4331,217032,207149,c,5223
5224,2259,906,4099,0,209936,217200,209936,t,5224
5225,206950,4038,2114,0,3761,216863,206950,a,5225
5226,210229,3043,2730,0,1651,217653,210229,a,5226
5227,1899,930,213908,0,2820,219557,213908,g,5227
5228,209773,2662,1466,0,4524,218425,209773,a,5228
5229,1380,1046,213889,0,1965,218280,213889,g,5229
5230,1165,965,212426,0,2238,216794,212426,g,5230
5231,207488,2965,1266,0,5113,216832,207488,a,5231
5232,2514,209497,2252,0,3401,217664,209497,c,5232
5233,1901,1193,2752,0,210440,216286,210440,t,5233
5234,587,754,1336,0,212906,215583,212906,t,5234
5235,1940,210181,2183,0,2709,217013,210181,c,5235
5236,2048,210839,2699,0,1661,217247,210839,c,5236
5237,210829,2141,2105,0,1447,216522,210829,a,5237
5238,208883,1606,2640,0,1546,214675,208883,a,5238
5239,1569,477,1522,0,209611,213179,209611,t,5239
5240,203728,1924,1511,0,1363,208526,203728,a,5240
5241,204948,1768,1561,0,1011,209288,204948,a,5241
5242,1576,614,206192,0,735,209117,206192,g,5242
5243,202276,1875,1031,0,1466,206648,202276,a,5243
5244,1852,599,3339,0,200991,206781,200991,t,5244
5245,198282,2287,1175,0,4615,206359,198282,a,5245
5246,2614,199361,2858,0,5413,210246,199361,c,5246
5247,1813,203993,2470,0,1312,209588,203993,c,5247
5248,204147,1708,2251,0,799,208905,204147,a,5248
5249,202938,1272,3341,0,789,208340,202938,a,5249
5250,203599,1557,1240,0,1939,208335,203599,a,5250
5251,3803,200601,2160,0,2409,208973,200601,c,5251
5252,2912,199284,2177,0,1439,205812,199284,c,5252
5253,1946,199027,2478,0,4085,207536,199027,c,5253
5254,2145,201022,2236,0,1650,207053,201022,c,5254
5255,199971,2605,2078,0,1776,206430,199971,a,5255
5256,2300,1265,201155,0,1516,206236,201155,g,5256
5257,2698,197651,1886,0,2102,204337,197651,c,5257
5258,1593,198260,2833,0,4561,207247,198260,c,5258
5259,202799,2630,1833,0,2045,209307,202799,a,5259
5260,2370,566,1570,0,207619,212125,207619,t,5260
5261,2432,208774,1515,0,1420,214141,208774,c,5261
5262,209409,2892,1333,0,1543,215177,209409,a,5262
5263,2453,848,211762,0,959,216022,211762,g,5263
5264,210968,2390,1220,0,2691,217269,210968,a,5264
5265,2409,1176,213303,0,1436,218324,213303,g,5265
5266,2245,212023,1393,0,2299,217960,212023,c,5266
5267,2442,1219,1873,0,212547,218081,212547,t,5267
5268,1171,805,214242,0,2107,218325,214242,g,5268
5269,213345,2196,1162,0,1222,217925,213345,a,5269
5270,1597,543,213939,0,925,217004,213939,g,5270
5271,3718,205644,927,0,1058,211347,205644,c,5271
5272,206081,2412,1142,0,1720,211355,206081,a,5272
5273,2847,204886,2694,0,945,211372,204886,c,5273
5274,202759,2768,2064,0,2918,210509,202759,a,5274
5275,2584,203631,1878,0,2792,210885,203631,c,5275
5276,2132,204660,1430,0,1013,209235,204660,c,5276
5277,1477,1570,204183,0,991,208221,204183,g,5277
5278,2727,657,202510,0,1769,207663,202510,g,5278
5279,2737,716,197623,0,3570,204646,197623,g,5279
5280,3544,197774,1522,0,2922,205762,197774,c,5280
5281,1553,1112,198073,0,2579,203317,198073,g,5281
5282,1503,633,200041,0,888,203065,200041,g,5282
5283,4010,742,194938,0,1475,201165,194938,g,5283
5284,194610,2980,1374,0,809,199773,194610,a,5284
5285,2370,587,196176,0,767,199900,196176,g,5285
5286,194205,2433,871,0,874,198383,194205,a,5286
5287,1876,756,4323,0,193986,200941,193986,t,5287
5288,1635,4200,846,0,196707,203388,196707,t,5288
5289,822,443,201555,0,1892,204712,201555,g,5289
5290,2422,1664,2471,0,197269,203826,197269,t,5290
5291,3150,973,198659,0,1023,203805,198659,g,5291
5292,1429,479,194686,0,3372,199966,194686,g,5292
5293,184606,1906,1241,0,1527,189280,184606,a,5293
5294,2697,178272,5526,0,4143,190638,178272,c,5294
5295,4384,180594,4153,1,1201,190333,180594,c,5295
5296,1773,911,4696,0,182678,190058,182678,t,5296
5297,184851,2934,1290,0,711,189786,184851,a,5297
5298,182338,1771,4399,0,1217,189725,182338,a,5298
5299,6014,1826,2526,0,180028,190394,180028,t,5299
5300,975,604,186916,0,2680,191175,186916,g,5300
5301,3634,3730,3133,0,181725,192222,181725,t,5301
5302,1208,523,189676,0,1016,192423,189676,g,5302
5303,1645,769,2066,0,187146,191626,187146,t,5303
5304,3069,184648,2588,0,1071,191376,184648,c,5304
5305,181539,2108,4484,0,1538,189669,181539,a,5305
5306,2922,1115,2995,0,185349,192381,185349,t,5306
5307,1383,1200,190302,0,1428,194313,190302,g,5307
5308,3005,185885,2553,0,2601,194044,185885,c,5308
5309,3965,185949,2149,0,885,192948,185949,c,5309
5310,186491,2464,1638,0,1282,191875,186491,a,5310
5311,2641,184448,3018,0,1267,191374,184448,c,5311
5312,185901,2438,1668,0,771,190778,185901,a,5312
5313,1479,444,2334,0,185775,190032,185775,t,5313
5314,1028,694,1391,0,186837,189950,186837,t,5314
5315,1870,185126,1869,0,905,189770,185126,c,5315
5316,183748,2931,1552,0,2610,190841,183748,a,5316
5317,2238,187146,1309,0,1160,191853,187146,c,5317
5318,1396,1351,1605,0,185746,190098,185746,t,5318
5319,182821,1799,680,0,1144,186444,182821,a,5319
5320,1399,491,1002,0,183459,186351,183459,t,5320
5321,856,877,183367,0,916,186016,183367,g,5321
5322,182257,1927,684,0,2049,186917,182257,a,5322
5323,1076,708,185011,0,1608,188403,185011,g,5323
5324,1171,611,182216,0,1935,185933,182216,g,5324
5325,1786,181816,1668,0,997,186267,181816,c,5325
5326,1247,1161,1152,0,183317,186877,183317,t,5326
5327,551,1020,184821,0,1806,188198,184821,g,5327
5328,1621,183904,1614,0,1127,188266,183904,c,5328
5329,789,696,1651,0,185370,188506,185370,t,5329
5330,184408,1448,958,0,982,187796,184408,a,5330
5331,1115,382,1161,0,186596,189254,186596,t,5331
5332,1732,186327,1245,0,1727,191031,186327,c,5332
5333,186420,2459,1512,0,1145,191536,186420,a,5333
5334,2027,186968,1552,0,1278,191825,186968,c,5334
5335,1584,187586,1502,0,1467,192139,187586,c,5335
5336,186787,3230,1323,0,3933,195273,186787,a,5336
5337,663,360,194851,0,1046,196920,194851,g,5337
5338,1589,707,1715,0,192567,196578,192567,t,5338
5339,1145,447,770,0,194503,196865,194503,t,5339
5340,193656,1450,862,0,515,196483,193656,a,5340
5341,1173,372,194222,0,493,196260,194222,g,5341
5342,191797,1748,967,0,1517,196029,191797,a,5342
5343,908,408,194114,0,1000,196430,194114,g,5343
5344,2681,1681,1472,0,190020,195854,190020,t,5344
5345,822,378,194344,0,2152,197696,194344,g,5345
5346,1656,193912,711,0,3043,199322,193912,c,5346
5347,1507,195565,2039,0,827,199938,195565,c,5347
5348,193913,1659,2722,0,713,199007,193913,a,5348
5349,193608,1226,1646,0,1623,198103,193608,a,5349
5350,194951,1490,1105,0,1371,198917,194951,a,5350
5351,845,373,2034,0,196271,199523,196271,t,5351
5352,1398,1027,657,0,196015,199097,196015,t,5352
5353,194550,1325,2009,0,1052,198936,194550,a,5353
5354,2063,194180,1969,0,791,199003,194180,c,5354
5355,193805,1105,1788,0,611,197309,193805,a,5355
5356,192744,878,1214,0,3191,198027,192744,a,5356
5357,2010,193858,931,0,2316,199115,193858,c,5357
5358,1796,194254,1822,0,3120,200992,194254,c,5358
5359,1142,932,1783,0,198320,202177,198320,t,5359
5360,628,623,199623,0,825,201699,199623,g,5360
5361,196539,1400,1220,0,1720,200879,196539,a,5361
5362,2371,518,1704,0,196215,200808,196215,t,5362
5363,1485,193864,2177,0,760,198286,193864,c,5363
5364,193424,1119,2593,0,910,198046,193424,a,5364
5365,888,308,1598,0,196766,199560,196766,t,5365
5366,1576,197031,765,0,1341,200713,197031,c,5366
5367,195411,1647,2386,0,1610,201054,195411,a,5367
5368,1718,825,1167,0,196576,200286,196576,t,5368
5369,800,729,198495,0,2153,202177,198495,g,5369
5370,1207,312,198372,0,2756,202647,198372,g,5370
5371,197707,2001,1087,0,2878,203673,197707,a,5371
5372,2412,198688,2122,0,939,204161,198688,c,5372
5373,1166,605,198995,0,821,201587,198995,g,5373
5374,197283,1299,1301,0,935,200818,197283,a,5374
5375,197635,1428,1060,0,2850,202973,197635,a,5375
5376,1536,697,200360,0,1909,204502,200360,g,5376
5377,2516,198800,885,0,1510,203711,198800,c,5377
5378,1754,196872,2723,0,942,202291,196872,c,5378
5379,1280,197700,1621,0,3343,203944,197700,c,5379
5380,198632,1548,2003,0,1243,203426,198632,a,5380
5381,639,388,1598,0,200012,202637,200012,t,5381
5382,1857,1395,726,0,197213,201191,197213,t,5382
5383,527,328,2291,0,200742,203888,200742,t,5383
5384,1923,197810,1308,0,1764,202805,197810,c,5384
5385,196210,1466,1990,0,2107,201773,196210,a,5385
5386,1660,196535,1981,0,1412,201588,196535,c,5386
5387,194286,1933,1883,0,777,198879,194286,a,5387
5388,1291,335,196317,0,652,198595,196317,g,5388
5389,193278,1418,1949,0,1085,197730,193278,a,5389
5390,2602,190567,1770,0,2216,197155,190567,c,5390
5391,2765,191001,1056,0,2743,197565,191001,c,5391
5392,1901,191827,2611,0,3370,199709,191827,c,5392
5393,196731,1121,1373,0,1964,201189,196731,a,5393
5394,1202,737,198481,0,1638,202058,198481,g,5394
5395,1867,197138,1393,0,1023,201421,197138,c,5395
5396,193956,1474,2116,0,1772,199318,193956,a,5396
5397,193760,2561,1589,0,1410,199320,193760,a,5397
5398,796,282,197416,0,1046,199540,197416,g,5398
5399,2090,842,1051,0,195440,199423,195440,t,5399
5400,194718,1055,2358,0,1281,199412,194718,a,5400
5401,1043,439,1403,0,197785,200670,197785,t,5401
5402,198013,1129,1120,0,1050,201312,198013,a,5402
5403,1386,549,198032,0,1069,201036,198032,g,5403
5404,1809,195182,1020,0,908,198919,195182,c,5404
5405,1199,532,195396,0,651,197778,195396,g,5405
5406,1032,371,189606,0,2334,193343,189606,g,5406
5407,5097,179963,1512,0,1633,188205,179963,c,5407
5408,3753,2085,2830,0,177720,186388,177720,t,5408
5409,179528,1674,969,0,1004,183175,179528,a,5409
5410,2348,636,177994,0,2200,183178,177994,g,5410
5411,173425,3648,1385,0,1142,179600,173425,a,5411
5412,1804,923,175663,0,1501,179891,175663,g,5412
5413,1342,1352,173041,0,2892,178627,173041,g,5413
5414,167506,2391,4980,0,1655,176532,167506,a,5414
5415,7424,1410,2113,0,164554,175501,164554,t,5415
5416,168548,2164,1779,0,1791,174282,168548,a,5416
5417,4051,164163,5141,0,1493,174848,164163,c,5417
5418,166464,3393,3770,0,1363,174990,166464,a,5418
5419,2014,1516,2744,0,177352,183626,177352,t,5419
5420,2595,181809,2768,0,1422,188594,181809,c,5420
5421,1991,5063,2473,0,178738,188265,178738,t,5421
5422,2363,181880,2260,0,1190,187693,181880,c,5422
5423,177880,5048,3338,0,813,187079,177880,a,5423
5424,181651,1732,2034,0,2110,187527,181651,a,5424
5425,5440,177967,3306,0,1039,187752,177967,c,5425
5426,1622,2336,2994,0,180548,187500,180548,t,5426
5427,4204,180881,1349,0,724,187158,180881,c,5427
5428,785,1637,183676,0,493,186591,183676,g,5428
5429,176194,4183,2257,0,3356,185990,176194,a,5429
5430,1351,617,183259,0,659,185886,183259,g,5430
5431,2737,1501,2269,0,177577,184084,177577,t,5431
5432,179827,2051,1046,0,917,183841,179827,a,5432
5433,2292,911,179581,0,912,183696,179581,g,5433
5434,178703,2367,2188,0,543,183801,178703,a,5434
5435,2246,518,178947,0,2033,183744,178947,g,5435
5436,176439,4014,934,0,1369,182756,176439,a,5436
5437,2918,967,1374,0,179962,185221,179962,t,5437
5438,1201,2462,181461,0,1833,186957,181461,g,5438
5439,985,408,184488,0,1711,187592,184488,g,5439
5440,668,594,185459,0,858,187579,185459,g,5440
5441,3028,1209,5006,0,177285,186528,177285,t,5441
5442,1197,367,183889,0,844,186297,183889,g,5442
5443,179442,2276,2394,0,2249,186361,179442,a,5443
5444,1945,692,183078,0,1192,186907,183078,g,5444
5445,1406,966,181359,0,827,184558,181359,g,5445
5446,2724,176482,2167,0,1296,182669,176482,c,5446
5447,174757,4683,921,0,461,180822,174757,a,5447
5448,1858,764,176706,0,2632,181960,176706,g,5448
5449,3082,176637,1289,0,1323,182331,176637,c,5449
5450,1154,1853,1983,0,177183,182173,177183,t,5450
5451,790,1473,177375,0,920,180558,177375,g,5451
5452,1313,228,176230,0,574,178345,176230,g,5452
5453,711,185,175755,0,862,177513,175755,g,5453
5454,169918,2392,2612,0,782,175704,169918,a,5454
5455,2079,472,2064,0,170455,175070,170455,t,5455
5456,733,1244,1145,0,171937,175059,171937,t,5456
5457,1097,398,1858,0,171716,175069,171716,t,5457
5458,497,363,1083,0,173195,175138,173195,t,5458
5459,2162,170598,511,0,1125,174396,170598,c,5459
5460,167895,2962,2392,0,567,173816,167895,a,5460
5461,1353,284,1772,0,167589,170998,167589,t,5461
5462,1461,380,167728,0,1215,170784,167728,g,5462
5463,166415,1583,809,0,1557,170364,166415,a,5463
5464,4330,164119,1432,0,1356,171237,164119,c,5464
5465,166327,3136,700,0,1158,171321,166327,a,5465
5466,2518,670,167880,0,661,171729,167880,g,5466
5467,2438,165474,1350,0,962,170224,165474,c,5467
5468,2075,165430,1960,0,533,169998,165430,c,5468
5469,165206,2593,739,0,1224,169762,165206,a,5469
5470,3317,164516,1434,0,294,169561,164516,c,5470
5471,1994,2906,1643,0,162804,169347,162804,t,5471
5472,1791,165227,987,0,2286,170291,165227,c,5472
5473,1253,167223,1930,0,276,170682,167223,c,5473
5474,889,1838,991,0,166566,170284,166566,t,5474
5475,2228,166180,608,0,1549,170565,166180,c,5475
5476,1336,166853,1902,0,746,170837,166853,c,5476
5477,860,1125,165841,0,726,168552,165841,g,5477
5478,879,271,164720,0,840,166710,164720,g,5478
5479,1393,182,163636,0,665,165876,163636,g,5479
5480,160117,1958,2431,0,2036,166542,160117,a,5480
5481,164007,1157,956,0,822,166942,164007,a,5481
5482,2009,486,163425,0,4890,170810,163425,g,5482
5483,2678,167660,1771,0,824,172933,167660,c,5483
5484,168559,2329,1153,0,592,172633,168559,a,5484
5485,1554,288,170058,0,414,172314,170058,g,5485
5486,166995,2036,1368,0,1039,171438,166995,a,5486
5487,2078,332,167836,0,676,170922,167836,g,5487
5488,158680,1513,830,0,1605,162628,158680,a,5488
5489,3135,155360,2252,0,1464,162211,155360,c,5489
5490,2440,154233,1921,0,1616,160210,154233,c,5490
5491,1970,154426,2860,0,2721,161977,154426,c,5491
5492,155740,4158,2084,0,725,162707,155740,a,5492
5493,2093,480,2545,0,155493,160611,155493,t,5493
5494,2003,759,1545,0,155515,159822,155515,t,5494
5495,2399,152268,2210,0,2651,159528,152268,c,5495
5496,1457,154294,2940,0,5163,163854,154294,c,5496
5497,1903,159346,2935,0,986,165170,159346,c,5497
5498,1222,792,3011,0,160591,165616,160591,t,5498
5499,2234,159308,1318,0,1751,164611,159308,c,5499
5500,158486,3171,1339,0,1285,164281,158486,a,5500
5501,1797,711,161078,0,670,164256,161078,g,5501
5502,156584,1988,2773,0,955,162300,156584,a,5502
5503,1466,446,159324,0,1315,162551,159324,g,5503
5504,4386,152135,1235,0,1200,158956,152135,c,5504
5505,153299,2503,2497,0,697,158996,153299,a,5505
5506,154046,1447,2431,0,963,158887,154046,a,5506
5507,2707,1039,1761,0,152312,157819,152312,t,5507
5508,1635,646,152807,0,3182,158270,152807,g,5508
5509,2161,151184,3054,0,1922,158321,151184,c,5509
5510,151679,2301,2440,0,642,157062,151679,a,5510
5511,3204,148423,2672,0,2743,157042,148423,c,5511
5512,4369,142416,2309,0,538,149632,142416,c,5512
5513,140924,2417,4219,0,815,148375,140924,a,5513
5514,143147,1923,2592,0,770,148432,143147,a,5514
5515,1712,734,2280,0,144747,149473,144747,t,5515
5516,1641,145706,1091,0,1147,149585,145706,c,5516
5517,139778,2882,4180,0,1315,148155,139778,a,5517
5518,1424,1691,2449,0,142627,148191,142627,t,5518
5519,1207,955,145665,0,695,148522,145665,g,5519
5520,950,478,141304,0,2476,145208,141304,g,5520
5521,133113,2094,2688,0,1514,139409,133113,a,5521
5522,2369,854,5125,0,131079,139427,131079,t,5522
5523,2155,791,135068,0,1130,139144,135068,g,5523
5524,131226,1702,3418,0,2538,138884,131226,a,5524
5525,133279,2456,2396,0,699,138830,133279,a,5525
5526,2653,863,134918,0,479,138913,134918,g,5526
5527,132807,1436,2407,0,775,137425,132807,a,5527
5528,130942,1087,3339,0,1557,136925,130942,a,5528
5529,133293,1734,1047,0,2712,138786,133293,a,5529
5530,1393,382,136759,0,1219,139753,136759,g,5530
5531,131744,1711,2322,0,2980,138757,131744,a,5531
5532,988,525,136799,0,1306,139618,136799,g,5532
5533,133606,1631,1568,0,1900,138705,133606,a,5533
5534,133113,1123,3203,0,1043,138482,133113,a,5534
5535,134431,1571,1342,0,842,138186,134431,a,5535
5536,1927,804,1981,0,132814,137526,132814,t,5536
5537,2117,132251,1304,0,5036,140708,132251,c,5537
5538,1474,135647,2457,0,4306,143884,135647,c,5538
5539,1102,139656,2726,0,1629,145113,139656,c,5539
5540,1416,729,2784,0,140281,145210,140281,t,5540
5541,888,405,143096,0,1018,145407,143096,g,5541
5542,139561,1478,2266,0,1086,144391,139561,a,5542
5543,139945,806,1912,0,1939,144602,139945,a,5543
5544,2649,139444,1789,0,866,144748,139444,c,5544
5545,692,794,142319,0,496,144301,142319,g,5545
5546,2306,1213,1522,0,138306,143347,138306,t,5546
5547,832,766,1729,0,140147,143474,140147,t,5547
5548,1511,140426,760,0,2923,145620,140426,c,5548
5549,329,513,145180,0,904,146926,145180,g,5549
5550,1069,774,1192,0,143372,146407,143372,t,5550
5551,1038,764,144024,0,534,146360,144024,g,5551
5552,544,287,143333,0,1115,145279,143333,g,5552
5553,141893,1528,754,0,2270,146445,141893,a,5553
5554,885,363,145082,0,706,147036,145082,g,5554
5555,1460,794,1154,0,143364,146772,143364,t,5555
5556,791,380,803,0,147480,149454,147480,t,5556
5557,1097,147959,1025,0,1134,151215,147959,c,5557
5558,636,396,1216,0,149000,151248,149000,t,5558
5559,712,286,149678,0,561,151237,149678,g,5559
5560,885,163,148542,0,439,150029,148542,g,5560
5561,147223,876,796,0,814,149709,147223,a,5561
5562,2032,146152,962,0,619,149765,146152,c,5562
5563,146477,1416,1054,0,398,149345,146477,a,5563
5564,1246,411,719,0,146873,149249,146873,t,5564
5565,644,688,147478,0,724,149534,147478,g,5565
5566,146690,1103,764,0,913,149470,146690,a,5566
5567,708,216,148215,0,530,149669,148215,g,5567
5568,1338,574,845,0,146204,148961,146204,t,5568
5569,748,549,147005,0,318,148620,147005,g,5569
5570,410,466,146785,0,1609,149270,146785,g,5570
5571,1004,127,148094,0,433,149658,148094,g,5571
5572,813,376,789,0,148608,150586,148608,t,5572
5573,1581,148908,442,0,911,151842,148908,c,5573
5574,149598,975,681,0,3197,154451,149598,a,5574
5575,1195,153819,463,0,2081,157558,153819,c,5575
5576,287,229,157412,0,320,158248,157412,g,5576
5577,260,247,156990,0,679,158176,156990,g,5577
5578,154625,1368,563,0,548,157104,154625,a,5578
5579,532,224,776,0,155860,157392,155860,t,5579
5580,367,647,604,0,155479,157097,155479,t,5580
5581,206,127,945,0,155575,156853,155575,t,5581
5582,837,271,470,0,153886,155464,153886,t,5582
5583,151652,446,1316,0,404,153818,151652,a,5583
5584,150802,791,371,0,853,152817,150802,a,5584
5585,148450,956,312,0,1520,151238,148450,a,5585
5586,513,1163,149121,0,946,151743,149121,g,5586
5587,663,198,143906,0,811,145578,143906,g,5587
5588,600,169,144449,0,405,145623,144449,g,5588
5589,143604,1114,335,0,468,145521,143604,a,5589
5590,143171,1009,726,0,745,145651,143171,a,5590
5591,753,424,143458,0,228,144863,143458,g,5591
5592,139616,908,410,0,377,141311,139616,a,5592
5593,700,135088,4454,0,339,140581,135088,c,5593
5594,465,2873,400,0,141102,144840,141102,t,5594
5595,154,229,146809,0,736,147928,146809,g,5595
5596,834,223,475,0,147242,148774,147242,t,5596
5597,1200,2601,617,0,144424,148842,144424,t,5597
5598,460,670,3468,0,144407,149005,144407,t,5598
5599,692,148,145403,0,5488,151731,145403,g,5599
5600,224,224,152321,0,494,153263,152321,g,5600
5601,1229,441,761,0,150443,152874,150443,t,5601
5602,2810,200,482,0,149046,152538,149046,t,5602
5603,1062,148544,2481,0,609,152696,148544,c,5603
5604,119,74,152265,0,194,152652,152265,g,5604
5605,642,258,2546,0,149117,152563,149117,t,5605
5606,2309,289,660,0,149305,152563,149305,t,5606
5607,2845,148568,404,0,1992,153809,148568,c,5607
5608,3271,150063,461,0,463,154258,150063,c,5608
5609,150844,566,2519,0,523,154452,150844,a,5609
5610,152639,1283,357,0,846,155125,152639,a,5610
5611,117,68,154998,0,650,155833,154998,g,5611
5612,701,413,608,0,153646,155368,153646,t,5612
5613,152189,425,2467,0,275,155356,152189,a,5613
5614,295,104,467,0,154734,155600,154734,t,5614
5615,154000,557,236,0,381,155174,154000,a,5615
5616,152600,816,1464,0,424,155304,152600,a,5616
5617,153508,809,450,0,394,155161,153508,a,5617
5618,152980,801,210,0,1062,155053,152980,a,5618
5619,1228,566,151981,0,2368,156143,151981,g,5619
5620,1059,149549,278,0,1422,152308,149549,c,5620
5621,150940,841,388,0,1490,153659,150940,a,5621
5622,691,86,150144,0,1033,151954,150144,g,5622
5623,545,130,149753,0,2267,152695,149753,g,5623
5624,151274,636,910,0,777,153597,151274,a,5624
5625,151582,663,520,0,1492,154257,151582,a,5625
5626,152377,1154,563,0,1800,155894,152377,a,5626
5627,722,538,803,0,155172,157235,155172,t,5627
5628,257,353,156840,0,246,157696,156840,g,5628
5629,155848,570,955,0,402,157775,155848,a,5629
5630,791,286,354,0,156436,157867,156436,t,5630
5631,157512,583,569,0,795,159459,157512,a,5631
5632,402,146,1389,0,159563,161500,159563,t,5632
5633,161357,557,151,0,877,162942,161357,a,5633
5634,650,185,161899,0,863,163597,161899,g,5634
5635,1271,161357,405,0,444,163477,161357,c,5635
5636,161134,715,1306,0,500,163655,161134,a,5636
5637,362,169,161758,0,1627,163916,161758,g,5637
5638,1134,161028,322,0,332,162816,161028,c,5638
5639,272,186,1355,0,160537,162350,160537,t,5639
5640,253,523,247,0,161056,162079,161056,t,5640
5641,203,118,161439,0,347,162107,161439,g,5641
5642,928,159552,392,0,755,161627,159552,c,5642
5643,1239,159553,399,0,836,162027,159553,c,5643
5644,722,112,471,0,160350,161655,160350,t,5644
5645,211,136,160848,0,308,161503,160848,g,5645
5646,158422,1205,1012,0,1618,162257,158422,a,5646
5647,552,153,162218,0,2399,165322,162218,g,5647
5648,163736,1295,463,0,679,166173,163736,a,5648
5649,164271,899,476,0,718,166364,164271,a,5649
5650,164821,884,345,0,494,166544,164821,a,5650
5651,164018,837,1072,0,461,166388,164018,a,5651
5652,164315,1054,414,0,530,166313,164315,a,5652
5653,162811,833,978,0,1101,165723,162811,a,5653
5654,286,281,430,0,164660,165657,164660,t,5654
5655,2493,700,152810,0,777,156780,152810,g,5655
5656,404,125,154981,0,1625,157135,154981,g,5656
5657,155182,882,833,0,771,157668,155182,a,5657
5658,154989,681,1026,0,1879,158575,154989,a,5658
5659,155478,1605,1396,0,1417,159896,155478,a,5659
5660,504,190,159049,0,640,160383,159049,g,5660
5661,157461,839,1250,0,2180,161730,157461,a,5661
5662,158799,747,1854,0,1538,162938,158799,a,5662
5663,159711,2106,384,0,1435,163636,159711,a,5663
5664,711,163,159426,0,759,161059,159426,g,5664
5665,5181,1104,1634,0,152636,160555,152636,t,5665
5666,760,978,157858,0,2062,161658,157858,g,5666
5667,155578,1021,2568,0,1534,160701,155578,a,5667
5668,1791,407,1822,0,156923,160943,156923,t,5668
5669,156736,659,1188,0,2642,161225,156736,a,5669
5670,1532,153564,5511,0,1412,162019,153564,c,5670
5671,159534,615,1087,0,266,161502,159534,a,5671
5672,154495,632,3264,0,4682,163073,154495,a,5672
5673,1888,158833,2298,0,518,163537,158833,c,5673
5674,1717,551,1519,0,158786,162573,158786,t,5674
5675,2171,157839,1579,0,1315,162904,157839,c,5675
5676,156747,1095,2455,0,3083,163380,156747,a,5676
5677,1031,202,161424,0,473,163130,161424,g,5677
5678,1286,422,1118,0,154010,156836,154010,t,5678
5679,151842,2872,1291,0,2841,158846,151842,a,5679
5680,571,221,158203,0,1399,160394,158203,g,5680
5681,1100,357,154662,0,1048,157167,154662,g,5681
5682,153213,962,1308,0,1608,157091,153213,a,5682
5683,153954,1315,293,0,592,156154,153954,a,5683
5684,1222,211,153206,0,462,155101,153206,g,5684
5685,152335,1076,322,0,630,154363,152335,a,5685
5686,955,146779,5172,0,8762,161668,146779,c,5686
5687,1316,160068,760,0,4004,166148,160068,c,5687
5688,337,213,4772,0,161155,166477,161155,t,5688
5689,641,650,575,0,164466,166332,164466,t,5689
5690,2016,2163,882,0,161163,166224,161163,t,5690
5691,494,123,164803,0,1043,166463,164803,g,5691
5692,162656,864,450,0,1925,165895,162656,a,5692
5693,688,154,2112,0,162941,165895,162941,t,5693
5694,492,536,389,0,164331,165748,164331,t,5694
5695,2062,162269,589,0,878,165798,162269,c,5695
5696,780,388,1896,0,162372,165436,162372,t,5696
5697,269,261,163800,0,407,164737,163800,g,5697
5698,161476,591,684,0,1247,163998,161476,a,5698
5699,602,116,162616,0,288,163622,162616,g,5699
5700,1263,212,940,0,159255,161670,159255,t,5700
5701,159973,294,642,0,649,161558,159973,a,5701
5702,469,293,973,0,162192,163927,162192,t,5702
5703,446,567,163676,0,300,164989,163676,g,5703
5704,398,225,1078,0,166073,167774,166073,t,5704
5705,2013,166174,570,0,602,169359,166174,c,5705
5706,167590,640,472,0,442,169144,167590,a,5706
5707,167680,690,245,0,312,168927,167680,a,5707
5708,748,111,167609,0,878,169346,167609,g,5708
5709,166824,653,279,0,3709,171465,166824,a,5709
5710,900,170298,1224,0,515,172937,170298,c,5710
5711,503,214,401,0,170065,171183,170065,t,5711
5712,170320,460,478,0,925,172183,170320,a,5712
5713,731,187,171149,0,561,172628,171149,g,5713
5714,168352,517,259,0,348,169476,168352,a,5714
5715,166455,419,1026,0,1500,169400,166455,a,5715
5716,1037,166863,597,0,2370,170867,166863,c,5716
5717,1312,168000,1750,0,760,171822,168000,c,5717
5718,169890,559,1318,0,369,172136,169890,a,5718
5719,170261,740,691,0,381,172073,170261,a,5719
5720,1742,310,424,0,169688,172164,169688,t,5720
5721,369,177,169584,0,1445,171575,169584,g,5721
5722,169836,801,592,0,635,171864,169836,a,5722
5723,386,131,1094,0,172399,174010,172399,t,5723
5724,1277,1675,199,0,174174,177325,174174,t,5724
5725,472,340,177161,0,640,178613,177161,g,5725
5726,989,349,172468,0,816,174622,172468,g,5726
5727,1321,334,172015,0,343,174013,172015,g,5727
5728,170045,930,378,0,1678,173031,170045,a,5728
5729,1642,170103,938,0,966,173649,170103,c,5729
5730,1644,457,2460,0,167960,172521,167960,t,5730
5731,358,384,1141,0,171397,173280,171397,t,5731
5732,1286,171486,616,0,780,174168,171486,c,5732
5733,231,118,173410,0,390,174149,173410,g,5733
5734,885,218,582,0,171838,173523,171838,t,5734
5735,455,477,172131,0,2248,175311,172131,g,5735
5736,1191,204,172403,0,1243,175041,172403,g,5736
5737,1499,283,1810,0,171502,175094,171502,t,5737
5738,2309,170657,1312,0,351,174629,170657,c,5738
5739,171524,831,1109,0,607,174071,171524,a,5739
5740,2390,169689,1207,0,402,173688,169689,c,5740
5741,170324,544,1642,0,183,172693,170324,a,5741
5742,170781,547,907,0,3923,176158,170781,a,5742
5743,966,175102,2239,0,2065,180372,175102,c,5743
5744,713,691,616,0,179802,181822,179802,t,5744
5745,472,122,181066,0,560,182220,181066,g,5745
5746,179904,1006,208,0,1018,182136,179904,a,5746
5747,971,179456,1459,0,544,182430,179456,c,5747
5748,180027,610,891,0,225,181753,180027,a,5748
5749,203,80,807,0,180262,181352,180262,t,5749
5750,508,1007,828,0,178991,181334,178991,t,5750
5751,249,129,429,0,181904,182711,181904,t,5751
5752,1786,181193,115,0,536,183630,181193,c,5752
5753,181080,539,1765,0,517,183901,181080,a,5753
5754,247,90,182873,0,210,183420,182873,g,5754
5755,179027,634,764,0,766,181191,179027,a,5755
5756,178555,808,1251,0,612,181226,178555,a,5756
5757,178257,1049,872,0,404,180582,178257,a,5757
5758,1092,137,152,0,179212,180593,179212,t,5758
5759,558,1150,177962,0,271,179941,177962,g,5759
5760,1270,408,176751,0,808,179237,176751,g,5760
5761,842,332,177114,0,464,178752,177114,g,5761
5762,1801,631,630,0,177713,180775,177713,t,5762
5763,815,493,180249,0,1302,182859,180249,g,5763
5764,1330,179044,1144,0,2530,184048,179044,c,5764
5765,1664,181175,1331,0,397,184567,181175,c,5765
5766,181891,478,1270,0,297,183936,181891,a,5766
5767,181310,699,668,0,6004,188681,181310,a,5767
5768,812,189435,494,0,1305,192046,189435,c,5768
5769,554,450,1573,0,189581,192158,189581,t,5769
5770,225,154,689,0,192121,193189,192121,t,5770
5771,1002,190953,1010,0,468,193433,190953,c,5771
5772,191005,727,553,0,1035,193320,191005,a,5772
5773,190967,931,335,0,973,193206,190967,a,5773
5774,425,143,192516,0,542,193626,192516,g,5774
5775,524,218,188924,0,977,190643,188924,g,5775
5776,1390,187096,1012,0,621,190119,187096,c,5776
5777,1180,215,636,0,188330,190361,188330,t,5777
5778,1131,249,188720,0,329,190429,188720,g,5778
5779,187945,663,399,0,364,189371,187945,a,5779
5780,686,209,187916,0,239,189050,187916,g,5780
5781,186185,764,95,0,1064,188108,186185,a,5781
5782,483,173,187223,0,494,188373,187223,g,5782
5783,591,945,185724,0,2734,189994,185724,g,5783
5784,590,184,189398,0,633,190805,189398,g,5784
5785,1222,754,1213,0,190291,193480,190291,t,5785
5786,888,371,526,0,193149,194934,193149,t,5786
5787,192584,577,1519,0,526,195206,192584,a,5787
5788,608,125,535,0,196788,198056,196788,t,5788
5789,197711,667,311,0,616,199305,197711,a,5789
5790,456,149,197800,0,550,198955,197800,g,5790
5791,195668,758,336,0,2982,199744,195668,a,5791
5792,893,197515,978,0,3148,202534,197515,c,5792
5793,1814,199570,668,0,738,202790,199570,c,5793
5794,1059,198677,1181,0,1438,202355,198677,c,5794
5795,1698,197805,508,0,452,200463,197805,c,5795
5796,196137,434,1018,0,259,197848,196137,a,5796
5797,991,227,196310,0,240,197768,196310,g,5797
5798,190601,764,362,0,1513,193240,190601,a,5798
5799,1645,190332,1009,0,795,193781,190332,c,5799
5800,764,193,189739,0,785,191481,189739,g,5800
5801,918,187841,1454,0,1199,191412,187841,c,5801
5802,720,1009,939,0,188891,191559,188891,t,5802
5803,517,186,189499,0,2799,193001,189499,g,5803
5804,793,189041,941,0,2605,193380,189041,c,5804
5805,190262,819,924,0,482,192487,190262,a,5805
5806,628,171,2510,0,189115,192424,189115,t,5806
5807,359,187,191246,0,411,192203,191246,g,5807
5808,187933,769,2066,0,658,191426,187933,a,5808
5809,189818,823,540,0,1050,192231,189818,a,5809
5810,190038,992,1130,0,282,192442,190038,a,5810
5811,2731,187762,634,0,811,191938,187762,c,5811
5812,1252,184119,2581,0,636,188588,184119,c,5812
5813,186195,1208,531,0,2494,190428,186195,a,5813
5814,386,287,189950,0,297,190920,189950,g,5814
5815,3245,717,772,0,178286,183020,178286,t,5815
5816,531,500,3705,0,175718,180454,175718,t,5816
5817,177480,701,1308,0,666,180155,177480,a,5817
5818,593,123,1234,0,177877,179827,177877,t,5818
5819,173765,4211,505,0,1674,180155,173765,a,5819
5820,919,173228,4732,0,865,179744,173228,c,5820
5821,525,381,5063,0,171394,177363,171394,t,5821
5822,174641,886,1039,0,221,176787,174641,a,5822
5823,174757,703,505,0,2539,178504,174757,a,5823
5824,1460,173101,3903,0,1187,179651,173101,c,5824
5825,177477,611,511,0,821,179420,177477,a,5825
5826,319,161,178017,0,451,178948,178017,g,5826
5827,173745,1463,2856,0,588,178652,173745,a,5827
5828,400,183,670,0,177572,178825,177572,t,5828
5829,507,4047,173754,0,1313,179621,173754,g,5829
5830,291,190,179314,0,2101,181896,179314,g,5830
5831,957,557,719,0,179570,181803,179570,t,5831
5832,599,205,180795,0,387,181986,180795,g,5832
5833,177204,729,336,0,3136,181405,177204,a,5833
5834,180211,828,88,0,923,182050,180211,a,5834
5835,471,203,181169,0,1675,183518,181169,g,5835
5836,181958,969,452,0,925,184304,181958,a,5836
5837,534,202,183093,0,919,184748,183093,g,5837
5838,2874,180600,95,0,3502,187071,180600,c,5838
5839,452,264,185858,0,985,187559,185858,g,5839
5840,827,253,184510,0,2768,188358,184510,g,5840
5841,1036,339,179675,0,602,181652,179675,g,5841
5842,3376,687,877,0,175970,180910,175970,t,5842
5843,753,160,179095,0,348,180356,179095,g,5843
5844,178204,612,921,0,285,180022,178204,a,5844
5845,628,148,597,0,180253,181626,180253,t,5845
5846,864,180727,259,0,1077,182927,180727,c,5846
5847,837,177399,1949,0,1837,182022,177399,c,5847
5848,500,1626,902,0,179370,182398,179370,t,5848
5849,559,549,181878,0,1277,184263,181878,g,5849
5850,791,192,181605,0,987,183575,181605,g,5850
5851,2766,175839,1005,0,1766,181376,175839,c,5851
5852,176134,901,1494,0,283,178812,176134,a,5852
5853,886,165,177359,0,321,178731,177359,g,5853
5854,1676,291,175725,0,610,178302,175725,g,5854
5855,174151,1319,1259,0,1754,178483,174151,a,5855
5856,1467,175482,934,0,1029,178912,175482,c,5856
5857,1424,174365,2498,0,320,178607,174365,c,5857
5858,453,314,1103,0,176669,178539,176669,t,5858
5859,175493,1610,809,0,546,178458,175493,a,5859
5860,556,448,1476,0,177055,179535,177055,t,5860
5861,575,491,177722,0,1642,180430,177722,g,5861
5862,1422,176304,1430,0,5197,184353,176304,c,5862
5863,1460,182582,516,0,1733,186291,182582,c,5863
5864,184794,888,375,0,763,186820,184794,a,5864
5865,436,120,186224,0,214,186994,186224,g,5865
5866,1020,406,1569,0,184112,187107,184112,t,5866
5867,448,255,185796,0,924,187423,185796,g,5867
5868,185702,673,402,0,3039,189816,185702,a,5868
5869,2315,187587,246,0,1514,191662,187587,c,5869
5870,2282,188692,355,0,2311,193640,188692,c,5870
5871,1462,191199,1263,0,793,194717,191199,c,5871
5872,193112,1167,265,0,5248,199792,193112,a,5872
5873,913,198679,1136,0,231,200959,198679,c,5873
5874,561,530,260,0,199806,201157,199806,t,5874
5875,833,198934,1126,0,236,201129,198934,c,5875
5876,716,426,292,0,199528,200962,199528,t,5876
5877,199754,804,156,0,434,201148,199754,a,5877
5878,415,177,200364,0,374,201330,200364,g,5878
5879,1537,511,716,0,198487,201251,198487,t,5879
5880,250,183,199367,0,603,200403,199367,g,5880
5881,971,198556,219,0,288,200034,198556,c,5881
5882,198405,933,168,0,424,199930,198405,a,5882
5883,249,185,199052,0,860,200346,199052,g,5883
5884,997,198934,168,0,222,200321,198934,c,5884
5885,198671,1237,184,0,945,201037,198671,a,5885
5886,1226,199828,104,0,367,201525,199828,c,5886
5887,197599,1049,93,0,221,198962,197599,a,5887
5888,196847,1348,123,0,816,199134,196847,a,5888
5889,197336,1691,157,0,420,199604,197336,a,5889
5890,380,148,198895,0,301,199724,198895,g,5890
5891,197180,1680,158,0,205,199223,197180,a,5891
5892,197201,1349,209,0,299,199058,197201,a,5892
5893,464,147,198140,0,501,199252,198140,g,5893
5894,192889,1583,348,0,1777,196597,192889,a,5894
5895,525,209,194194,0,1975,196903,194194,g,5895
5896,4924,343,172711,0,728,178706,172711,g,5896
5897,680,312,176496,0,691,178179,176496,g,5897
5898,175279,801,520,0,487,177087,175279,a,5898
5899,986,260,174990,0,1174,177410,174990,g,5899
5900,170508,1373,1707,0,716,174304,170508,a,5900
5901,172754,761,1258,0,363,175136,172754,a,5901
5902,1167,349,3723,0,169689,174928,169689,t,5902
5903,168616,4244,168,0,1957,174985,168616,a,5903
5904,457,227,174665,0,744,176093,174665,g,5904
5905,407,1055,171433,0,7865,180760,171433,g,5905
5906,178112,1426,1542,0,2961,184041,178112,a,5906
5907,180415,1809,777,0,1862,184863,180415,a,5907
5908,1163,555,182458,0,638,184814,182458,g,5908
5909,181075,1002,1319,0,938,184334,181075,a,5909
5910,175815,1258,3967,0,2079,183119,175815,a,5910
5911,178144,3009,1289,0,328,182770,178144,a,5911
5912,521,226,4959,0,176867,182573,176867,t,5912
5913,1092,175802,2723,0,4466,184083,175802,c,5913
5914,1925,178934,3494,0,1310,185663,178934,c,5914
5915,181929,898,2179,0,512,185518,181929,a,5915
5916,182146,781,985,0,1440,185352,182146,a,5916
5917,181739,832,1927,0,388,184886,181739,a,5917
5918,178982,759,3309,0,1497,184547,178982,a,5918
5919,182720,895,498,0,330,184443,182720,a,5919
5920,178669,782,4606,0,687,184744,178669,a,5920
5921,542,275,1686,0,182605,185108,182605,t,5921
5922,385,305,183494,0,568,184752,183494,g,5922
5923,180009,637,532,0,3044,184222,180009,a,5923
5924,182188,773,381,0,397,183739,182188,a,5924
5925,179348,793,2891,0,439,183471,179348,a,5925
5926,180772,815,1254,0,277,183118,180772,a,5926
5927,1280,321,336,0,181206,183143,181206,t,5927
5928,721,1968,180014,0,307,183010,180014,g,5928
5929,177657,716,665,0,3204,182242,177657,a,5929
5930,1327,179068,774,0,1327,182496,179068,c,5930
5931,2015,161051,1585,0,2969,167620,161051,c,5931
5932,161543,551,5386,0,1337,168817,161543,a,5932
5933,880,170,167155,0,567,168772,167155,g,5933
5934,5266,473,626,0,161721,168086,161721,t,5934
5935,164970,1211,680,0,2150,169011,164970,a,5935
5936,1278,162613,4739,0,537,169167,162613,c,5936
5937,164790,712,1362,0,962,167826,164790,a,5937
5938,880,443,4379,0,162195,167897,162195,t,5938
5939,162294,3774,778,0,300,167146,162294,a,5939
5940,1218,229,3844,0,161580,166871,161580,t,5940
5941,161625,1036,579,0,4282,167522,161625,a,5941
5942,1875,163788,1762,0,490,167915,163788,c,5942
5943,161635,710,3961,0,470,166776,161635,a,5943
5944,1205,1707,861,0,163367,167140,163367,t,5944
5945,964,670,166237,0,3794,171665,166237,g,5945
5946,2463,276,168547,0,3895,175181,168547,g,5946
5947,1883,687,172596,0,1569,176735,172596,g,5947
5948,1871,416,170130,0,645,173062,170130,g,5948
5949,970,394,170823,0,630,172817,170823,g,5949
5950,170096,782,622,0,482,171982,170096,a,5950
5951,169001,600,1584,0,826,172011,169001,a,5951
5952,3730,166406,939,0,989,172064,166406,c,5952
5953,2139,164175,5384,0,433,172131,164175,c,5953
5954,2618,300,856,0,170419,174193,170419,t,5954
5955,1415,170563,3243,0,2188,177409,170563,c,5955
5956,1185,339,2142,0,180175,183841,180175,t,5956
5957,1048,406,184719,0,2096,188269,184719,g,5957
5958,981,237,184478,0,3150,188846,184478,g,5958
5959,185416,713,1585,0,1975,189689,185416,a,5959
5960,186808,637,2034,0,498,189977,186808,a,5960
5961,187683,923,753,0,470,189829,187683,a,5961
5962,186734,784,893,0,1181,189592,186734,a,5962
5963,1471,783,1366,0,185985,189605,185985,t,5963
5964,1461,437,186303,0,1988,190189,186303,g,5964
5965,187546,720,1543,0,4902,194711,187546,a,5965
5966,1137,324,740,0,195885,198086,195885,t,5966
5967,857,244,196024,0,592,197717,196024,g,5967
5968,193153,730,334,0,2666,196883,193153,a,5968
5969,195287,843,438,0,796,197364,195287,a,5969
5970,1502,476,194789,0,556,197323,194789,g,5970
5971,194067,890,316,0,754,196027,194067,a,5971
5972,1116,192659,1210,0,1018,196003,192659,c,5972
5973,1125,1420,1331,0,190633,194509,190633,t,5973
5974,389,776,193139,0,990,195294,193139,g,5974
5975,1408,557,1035,0,191487,194487,191487,t,5975
5976,843,830,191313,0,745,193731,191313,g,5976
5977,1870,186339,1866,0,512,190587,186339,c,5977
5978,184292,614,881,0,1751,187538,184292,a,5978
5979,1318,182115,2855,0,901,187189,182115,c,5979
5980,182484,936,890,0,5412,189722,182484,a,5980
5981,2087,187456,1157,0,3407,194107,187456,c,5981
5982,518,1835,1528,0,191239,195120,191239,t,5982
5983,439,653,193717,0,1485,196294,193717,g,5983
5984,621,223,194915,0,1626,197385,194915,g,5984
5985,193708,754,766,0,524,195752,193708,a,5985
5986,192729,925,1222,0,1360,196236,192729,a,5986
5987,193939,803,508,0,2081,197331,193939,a,5987
5988,608,131,196650,0,1023,198412,196650,g,5988
5989,194463,1289,380,0,1997,198129,194463,a,5989
5990,195423,951,1848,0,2429,200651,195423,a,5990
5991,368,369,198991,0,6303,206031,198991,g,5991
5992,1172,200336,2152,0,797,204457,200336,c,5992
5993,465,184,2002,0,201511,204162,201511,t,5993
5994,201763,651,817,0,964,204195,201763,a,5994
5995,201645,775,1435,0,652,204507,201645,a,5995
5996,202391,1035,589,0,426,204441,202391,a,5996
5997,201034,918,1621,0,753,204326,201034,a,5997
5998,1509,439,536,0,201816,204300,201816,t,5998
5999,359,289,202658,0,1578,204884,202658,g,5999
6000,1406,202302,678,0,542,204928,202302,c,6000
6001,556,355,1074,0,203656,205641,203656,t,6001
6002,980,203099,279,0,1368,205726,203099,c,6002
6003,1104,200794,1617,0,464,203979,200794,c,6003
6004,328,191,550,0,200258,201327,200258,t,6004
6005,200243,557,440,0,900,202140,200243,a,6005
6006,313,127,201372,0,1796,203608,201372,g,6006
6007,201026,628,678,0,542,202874,201026,a,6007
6008,395,152,971,0,200934,202452,200934,t,6008
6009,199509,1035,329,0,378,201251,199509,a,6009
6010,198813,627,677,0,6472,206589,198813,a,6010
6011,1036,205867,1193,0,1160,209256,205867,c,6011
6012,200257,419,918,0,350,201944,200257,a,6012
6013,568,173,933,0,201429,203103,201429,t,6013
6014,1164,198837,1020,0,1176,202197,198837,c,6014
6015,199617,643,1100,0,677,202037,199617,a,6015
6016,198034,784,1220,0,3039,203077,198034,a,6016
6017,1476,200466,1897,0,334,204173,200466,c,6017
6018,193268,718,599,0,469,195054,193268,a,6018
6019,848,186801,5358,0,516,193523,186801,c,6019
6020,189495,908,768,0,2246,193417,189495,a,6020
6021,925,188509,705,0,3672,193811,188509,c,6021
6022,941,189882,2250,0,628,193701,189882,c,6022
6023,469,328,3352,0,189667,193816,189667,t,6023
6024,262,162,192874,0,1059,194357,192874,g,6024
6025,189906,810,246,0,2246,193208,189906,a,6025
6026,190788,1156,999,0,1015,193958,190788,a,6026
6027,512,330,192711,0,961,194514,192711,g,6027
6028,1117,157,191641,0,5501,198416,191641,g,6028
6029,196608,1847,1435,0,2349,202239,196608,a,6029
6030,200235,817,1599,0,276,202927,200235,a,6030
6031,2353,180,662,0,200639,203834,200639,t,6031
6032,1461,200432,1715,0,1317,204925,200432,c,6032
6033,201750,630,2238,0,349,204967,201750,a,6033
6034,663,212,1963,0,201981,204819,201981,t,6034
6035,479,208,2200,0,201791,204678,201791,t,6035
6036,1493,199706,802,0,4351,206352,199706,c,6036
6037,2880,202888,1273,0,653,207694,202888,c,6037
6038,773,292,1591,0,204554,207210,204554,t,6038
6039,204826,770,914,0,892,207402,204826,a,6039
6040,435,220,206208,0,790,207653,206208,g,6040
6041,1637,204132,607,0,320,206696,204132,c,6041
6042,203967,674,1188,0,726,206555,203967,a,6042
6043,962,521,484,0,206854,208821,206854,t,6043
6044,251,629,208973,0,470,210323,208973,g,6044
6045,987,249,1201,0,207757,210194,207757,t,6045
6046,560,294,402,0,209242,210498,209242,t,6046
6047,1118,208152,1036,0,571,210877,208152,c,6047
6048,497,137,209468,0,685,210787,209468,g,6048
6049,207711,716,788,0,524,209739,207711,a,6049
6050,207600,658,691,0,762,209711,207600,a,6050
6051,944,206506,674,0,1419,209543,206506,c,6051
6052,2391,202021,690,0,879,205981,202021,c,6052
6053,204631,674,344,0,440,206089,204631,a,6053
6054,736,246,205043,0,568,206593,205043,g,6054
6055,203942,1085,693,0,621,206341,203942,a,6055
6056,555,319,204038,0,1455,206367,204038,g,6056
6057,1273,204215,424,0,2053,207965,204215,c,6057
6058,275,124,208289,0,1480,210168,208289,g,6058
6059,844,407,532,0,209698,211481,209698,t,6059
6060,644,246,211714,0,821,213425,211714,g,6060
6061,211182,945,539,0,785,213451,211182,a,6061
6062,211333,1312,380,0,377,213402,211333,a,6062
6063,210104,1285,1122,0,371,212882,210104,a,6063
6064,210369,1451,733,0,1145,213698,210369,a,6064
6065,749,325,212723,0,1356,215153,212723,g,6065
6066,542,341,214551,0,361,215795,214551,g,6066
6067,3228,1375,897,0,211144,216644,211144,t,6067
6068,783,422,215543,0,405,217153,215543,g,6068
6069,459,171,214639,0,1583,216852,214639,g,6069
6070,215024,879,271,0,747,216921,215024,a,6070
6071,469,297,578,0,216099,217443,216099,t,6071
6072,387,706,216391,0,391,217875,216391,g,6072
6073,1099,214584,479,0,2625,218787,214584,c,6073
6074,1592,217676,268,0,829,220365,217676,c,6074
6075,218370,832,907,0,344,220453,218370,a,6075
6076,303,155,696,0,219694,220848,219694,t,6076
6077,527,277,274,0,219948,221026,219948,t,6077
6078,401,219,220092,0,924,221636,220092,g,6078
6079,219734,1162,593,0,1306,222795,219734,a,6079
6080,311,216,338,0,226012,226877,226012,t,6080
6081,274,476,227683,0,2042,230475,227683,g,6081
6082,442,294,229958,0,1095,231789,229958,g,6082
6083,1228,735,641,0,229604,232208,229604,t,6083
6084,437,242,231094,0,567,232340,231094,g,6084
6085,229967,963,361,0,508,231799,229967,a,6085
6086,229816,1021,206,0,1005,232048,229816,a,6086
6087,378,272,766,0,230811,232227,230811,t,6087
6088,229688,742,424,0,1272,232126,229688,a,6088
6089,1062,229937,757,0,1052,232808,229937,c,6089
6090,2076,229975,306,0,726,233083,229975,c,6090
6091,419,195,232127,0,2334,235075,232127,g,6091
6092,1510,232225,880,0,510,235125,232225,c,6092
6093,1053,343,723,0,229138,231257,229138,t,6093
6094,1336,772,454,0,229285,231847,229285,t,6094
6095,485,513,229743,0,458,231199,229743,g,6095
6096,227529,1649,588,0,807,230573,227529,a,6096
6097,632,202,228574,0,1552,230960,228574,g,6097
6098,224362,2846,426,0,3390,231024,224362,a,6098
6099,796,227,230534,0,455,232012,230534,g,6099
6100,539,512,229351,0,523,230925,229351,g,6100
6101,226721,1623,1064,0,1284,230692,226721,a,6101
6102,2687,509,227025,0,952,231173,227025,g,6102
6103,215411,1503,1948,0,1662,220524,215411,a,6103
6104,219443,1032,1220,0,1532,223227,219443,a,6104
6105,1657,326,220070,0,1058,223111,220070,g,6105
6106,4048,215098,915,0,928,220989,215098,c,6106
6107,215553,752,1027,0,3173,220505,215553,a,6107
6108,213976,3406,1850,0,5489,224721,213976,a,6108
6109,289,278,226000,0,4105,230672,226000,g,6109
6110,610,202,225879,0,2008,228699,225879,g,6110
6111,223919,1152,848,0,1528,227447,223919,a,6111
6112,225753,1123,726,0,347,227949,225753,a,6112
6113,220786,1041,5664,0,401,227892,220786,a,6113
6114,224284,1242,767,0,1663,227956,224284,a,6114
6115,1426,219566,5255,0,2459,228706,219566,c,6115
6116,1567,226298,1009,0,450,229324,226298,c,6116
6117,714,244,5461,0,222724,229143,222724,t,6117
6118,496,1339,903,0,227085,229823,227085,t,6118
6119,573,4905,1418,0,223585,230481,223585,t,6119
6120,483,190,229176,0,588,230437,229176,g,6120
6121,1381,409,631,0,226720,229141,226720,t,6121
6122,799,159,227609,0,532,229099,227609,g,6122
6123,716,183,222593,0,4868,228360,222593,g,6123
6124,224995,1105,465,0,1254,227819,224995,a,6124
6125,1391,220330,4905,0,1042,227668,220330,c,6125
6126,2081,218629,5389,0,461,226560,218629,c,6126
6127,593,380,5261,0,219773,226007,219773,t,6127
6128,223243,1091,863,0,256,225453,223243,a,6128
6129,222426,1291,831,0,566,225114,222426,a,6129
6130,4607,411,603,0,219198,224819,219198,t,6130
6131,460,516,220913,0,717,222606,220913,g,6131
6132,218101,1663,799,0,1699,222262,218101,a,6132
6133,771,185,220954,0,447,222357,220954,g,6133
6134,212172,1543,497,0,3707,217919,212172,a,6134
6135,212956,1727,1934,0,2037,218654,212956,a,6135
6136,745,928,212025,0,7014,220712,212025,g,6136
6137,211306,2300,1154,0,1828,216588,211306,a,6137
6138,747,456,213398,0,1274,215875,213398,g,6138
6139,5243,855,204989,0,1639,212726,204989,g,6139
6140,204915,1656,1804,0,3098,211473,204915,a,6140
6141,2279,882,207095,0,746,211002,207095,g,6141
6142,194157,1215,2075,0,2248,199695,194157,a,6142
6143,1843,187405,7478,0,3453,200179,187405,c,6143
6144,4635,188296,4354,0,1027,198312,188296,c,6144
6145,1038,236,9909,0,186189,197372,186189,t,6145
6146,188615,1859,1029,0,4949,196452,188615,a,6146
6147,5899,186162,1963,0,1786,195810,186162,c,6147
6148,1842,182532,9716,0,654,194744,182532,c,6148
6149,186239,1319,893,0,8334,196785,186239,a,6149
6150,800,216,197643,0,252,198911,197643,g,6150
6151,1703,2153,598,0,194044,198498,194044,t,6151
6152,4723,190148,2457,0,709,198037,190148,c,6152
6153,752,547,8126,0,188655,198080,188655,t,6153
6154,991,1963,190405,0,4492,197851,190405,g,6154
6155,1084,247,194667,0,252,196250,194667,g,6155
6156,3969,444,1160,0,189080,194653,189080,t,6156
6157,6907,650,1487,0,184070,193114,184070,t,6157
6158,2898,417,188105,0,1104,192524,188105,g,6158
6159,1367,219,189134,0,1021,191741,189134,g,6159
6160,2904,182755,4217,0,1448,191324,182755,c,6160
6161,3891,182201,3455,0,1393,190940,182201,c,6161
6162,3054,148,2288,0,186565,192055,186565,t,6162
6163,188934,865,1982,0,3710,195491,188934,a,6163
6164,3106,188896,2850,0,2266,197118,188896,c,6164
6165,195112,960,417,0,389,196878,195112,a,6165
6166,326,214,194586,0,434,195560,194586,g,6166
6167,189406,1432,474,0,2614,193926,189406,a,6167
6168,640,289,192489,0,853,194271,192489,g,6168
6169,1257,1327,694,0,191583,194861,191583,t,6169
6170,2475,430,191367,0,523,194795,191367,g,6170
6171,906,231,192410,0,1551,195098,192410,g,6171
6172,2382,185095,1827,0,2138,191442,185095,c,6172
6173,187574,1909,985,0,2428,192896,187574,a,6173
6174,705,634,188339,0,4141,193819,188339,g,6174
6175,3208,187687,1619,0,1390,193904,187687,c,6175
6176,1011,1945,2985,0,188330,194271,188330,t,6176
6177,908,1410,190460,0,1137,193915,190460,g,6177
6178,187060,2080,2315,0,1843,193298,187060,a,6178
6179,189693,1847,650,0,1230,193420,189693,a,6179
6180,3325,665,188790,0,2716,195496,188790,g,6180
6181,988,261,193316,0,3075,197640,193316,g,6181
6182,2636,191983,2309,0,1418,198346,191983,c,6182
6183,191633,3579,2402,0,231,197845,191633,a,6183
6184,2440,697,575,0,194858,198570,194858,t,6184
6185,2827,194892,425,0,927,199071,194892,c,6185
6186,192368,3865,2207,0,447,198887,192368,a,6186
6187,194673,1361,657,0,1838,198529,194673,a,6187
6188,4498,191295,2136,0,300,198229,191295,c,6188
6189,2110,1971,561,0,192871,197513,192871,t,6189
6190,193715,1937,519,0,3129,199300,193715,a,6190
6191,4356,193679,1701,0,432,200168,193679,c,6191
6192,1063,1870,195451,0,539,198923,195451,g,6192
6193,2180,194347,1196,0,616,198339,194347,c,6193
6194,191829,5299,662,0,328,198118,191829,a,6194
6195,3013,730,194027,0,517,198287,194027,g,6195
6196,194060,2001,846,0,1030,197937,194060,a,6196
6197,3939,192234,1550,0,1507,199230,192234,c,6197
6198,194427,3783,735,0,931,199876,194427,a,6198
6199,1600,398,197582,0,362,199942,197582,g,6199
6200,195090,2301,1137,0,1279,199807,195090,a,6200
6201,196776,1871,913,0,445,200005,196776,a,6201
6202,1749,684,196840,0,1237,200510,196840,g,6202
6203,1239,252,197265,0,485,199241,197265,g,6203
6204,3949,2408,9488,0,184685,200530,184685,t,6204
6205,1073,1192,197863,0,825,200953,197863,g,6205
6206,532,230,199136,0,515,200413,199136,g,6206
6207,3207,1810,9588,0,187525,202130,187525,t,6207
6208,549,428,201739,0,1684,204400,201739,g,6208
6209,1623,875,4582,0,197436,204516,197436,t,6209
6210,1061,664,773,0,201988,204486,201988,t,6210
6211,441,610,1164,0,200940,203155,200940,t,6211
6212,413,350,1277,0,201687,203727,201687,t,6212
6213,536,296,200162,0,3349,204343,200162,g,6213
6214,194030,1878,2018,0,1540,199466,194030,a,6214
6215,1604,698,1062,0,196201,199565,196201,t,6215
6216,1515,411,194690,0,904,197520,194690,g,6216
6217,690,177,194802,0,418,196087,194802,g,6217
6218,190521,1907,2804,0,1320,196552,190521,a,6218
6219,192601,1544,1336,0,1042,196523,192601,a,6219
6220,2336,633,1552,0,192125,196646,192125,t,6220
6221,988,380,1576,0,193339,196283,193339,t,6221
6222,191749,2243,1121,0,2931,198044,191749,a,6222
6223,195233,1036,2144,0,4418,202831,195233,a,6223
6224,2225,355,201299,0,716,204595,201299,g,6224
6225,189135,1204,987,0,493,191819,189135,a,6225
6226,187215,842,2602,0,1047,191706,187215,a,6226
6227,6209,180932,3493,0,737,191371,180932,c,6227
6228,184403,2245,881,0,2010,189539,184403,a,6228
6229,182585,1559,3128,0,1405,188677,182585,a,6229
6230,3850,180787,2722,0,2152,189511,180787,c,6230
6231,2817,182301,3816,0,855,189789,182301,c,6231
6232,182853,2555,2421,0,1776,189605,182853,a,6232
6233,184045,3524,1419,0,575,189563,184045,a,6233
6234,184534,1176,3714,0,227,189651,184534,a,6234
6235,2348,390,1414,0,188476,192628,188476,t,6235
6236,2848,187833,2211,0,604,193496,187833,c,6236
6237,723,566,3208,0,188288,192785,188288,t,6237
6238,2049,845,790,0,189514,193198,189514,t,6238
6239,504,430,191532,0,1667,194133,191532,g,6239
6240,784,226,187174,0,1937,190121,187174,g,6240
6241,182224,1819,2900,0,2075,189018,182224,a,6241
6242,185096,1135,3019,0,2227,191477,185096,a,6242
6243,2936,295,188679,0,1668,193578,188679,g,6243
6244,189454,1322,2089,0,555,193420,189454,a,6244
6245,189056,1084,2975,0,397,193512,189056,a,6245
6246,190020,1933,1086,0,441,193480,190020,a,6246
6247,188035,1105,3738,0,529,193407,188035,a,6247
6248,2515,850,1400,0,188848,193613,188848,t,6248
6249,976,618,189896,0,2707,194197,189896,g,6249
6250,2142,1284,3255,0,187472,194153,187472,t,6250
6251,2639,789,189285,0,618,193331,189285,g,6251
6252,922,213,186975,0,2134,190244,186975,g,6252
6253,182456,2035,2859,0,1670,189020,182456,a,6253
6254,1570,320,185381,0,4533,191804,185381,g,6254
6255,1584,975,188848,0,5055,196462,188848,g,6255
6256,2756,1299,6412,0,190573,201040,190573,t,6256
6257,1018,1333,199647,0,1216,203214,199647,g,6257
6258,960,228,199481,0,1143,201812,199481,g,6258
6259,194715,1463,3429,0,1367,200974,194715,a,6259
6260,195462,1509,2490,0,1069,200530,195462,a,6260
6261,196946,945,2139,0,569,200599,196946,a,6261
6262,2430,746,1301,0,197503,201980,197503,t,6262
6263,3259,196835,1304,0,1261,202659,196835,c,6263
6264,970,896,1700,0,199630,203196,199630,t,6264
6265,762,1135,200673,0,1743,204313,200673,g,6265
6266,982,289,197955,0,1257,200483,197955,g,6266
6267,193627,1367,1900,0,1774,198668,193627,a,6267
6268,4797,189968,2520,0,1079,198364,189968,c,6268
6269,191845,1570,2468,0,648,196531,191845,a,6269
6270,191557,1206,2331,0,1348,196442,191557,a,6270
6271,192223,2142,1667,0,695,196727,192223,a,6271
6272,192178,1928,1540,0,804,196450,192178,a,6272
6273,3108,692,191825,0,375,196000,191825,g,6273
6274,176391,1527,1077,0,1458,180453,176391,a,6274
6275,175330,2206,1715,0,1936,181187,175330,a,6275
6276,2706,1232,174587,0,4628,183153,174587,g,6276
6277,1369,2502,176087,0,3592,183550,176087,g,6277
6278,1003,905,180568,0,3025,185501,180568,g,6278
6279,1092,447,182642,0,2063,186244,182642,g,6279
6280,179537,1548,2517,0,2135,185737,179537,a,6280
6281,180499,1174,2126,0,999,184798,180499,a,6281
6282,178644,1469,3401,0,1277,184791,178644,a,6282
6283,1435,315,182638,0,3023,187411,182638,g,6283
6284,2128,445,184588,0,2906,190067,184588,g,6284
6285,186829,1473,1888,0,2925,193115,186829,a,6285
6286,191109,1478,1169,0,1137,194893,191109,a,6286
6287,3123,343,190754,0,813,195033,190754,g,6287
6288,189857,1097,1815,0,1164,193933,189857,a,6288
6289,188012,1134,3955,0,2165,195266,188012,a,6289
6290,190017,1143,2885,0,2983,197028,190017,a,6290
6291,1193,233,3777,0,192522,197725,192522,t,6291
6292,467,392,2264,0,194353,197476,194353,t,6292
6293,194200,727,1059,0,1400,197386,194200,a,6293
6294,193310,563,2732,0,316,196921,193310,a,6294
6295,193453,542,1941,0,366,196302,193453,a,6295
6296,191905,545,1411,0,2471,196332,191905,a,6296
6297,3967,189002,1507,0,1448,195924,189002,c,6297
6298,2694,189674,770,0,2121,195259,189674,c,6298
6299,2177,190600,981,0,1051,194809,190600,c,6299
6300,190200,1994,1823,0,557,194574,190200,a,6300
6301,1719,456,191764,0,285,194224,191764,g,6301
6302,186774,1206,1836,0,722,190538,186774,a,6302
6303,1673,438,1953,0,185754,189818,185754,t,6303
6304,692,912,187630,0,3649,192883,187630,g,6304
6305,983,163,191930,0,788,193864,191930,g,6305
6306,1388,663,2009,0,189902,193962,189902,t,6306
6307,1082,1439,815,0,191038,194374,191038,t,6307
6308,681,278,192699,0,702,194360,192699,g,6308
6309,598,582,190482,0,664,192326,190482,g,6309
6310,188776,1169,870,0,503,191318,188776,a,6310
6311,1390,407,912,0,190121,192830,190121,t,6311
6312,703,499,191419,0,10395,203016,191419,g,6312
6313,1868,204533,857,0,1966,209224,204533,c,6313
6314,2036,206841,804,0,750,210431,206841,c,6314
6315,207810,1342,761,0,609,210522,207810,a,6315
6316,1573,286,207829,0,789,210477,207829,g,6316
6317,678,232,203721,0,1745,206376,203721,g,6317
6318,204891,888,880,0,1610,208269,204891,a,6318
6319,2205,329,928,0,206884,210346,206884,t,6319
6320,1785,208213,621,0,603,211222,208213,c,6320
6321,687,302,1714,0,208461,211164,208461,t,6321
6322,208255,1064,1057,0,6709,217085,208255,a,6322
6323,2806,216234,1440,0,405,220885,216234,c,6323
6324,1501,542,873,0,217259,220175,217259,t,6324
6325,1860,214805,1608,0,612,218885,214805,c,6325
6326,1480,491,1462,0,215804,219237,215804,t,6326
6327,780,209,217404,0,659,219052,217404,g,6327
6328,215862,1083,771,0,528,218244,215862,a,6328
6329,2911,213156,1336,0,576,217979,213156,c,6329
6330,3712,207012,1187,0,1183,213094,207012,c,6330
6331,2187,205878,2756,0,646,211467,205878,c,6331
6332,207864,1377,1186,0,1385,211812,207864,a,6332
6333,1924,207373,1547,0,1850,212694,207373,c,6333
6334,1449,1465,2004,0,207471,212389,207471,t,6334
6335,927,317,209884,0,948,212076,209884,g,6335
6336,207485,863,863,0,4085,213296,207485,a,6336
6337,3242,208976,970,0,738,213926,208976,c,6337
6338,600,443,210214,0,694,211951,210214,g,6338
6339,2049,205158,2197,0,1323,210727,205158,c,6339
6340,1977,829,3306,0,204207,210319,204207,t,6340
6341,205735,1210,698,0,3777,211420,205735,a,6341
6342,208891,1314,1422,0,2280,213907,208891,a,6342
6343,210938,972,1806,0,2483,216199,210938,a,6343
6344,1253,341,213766,0,849,216209,213766,g,6344
6345,1091,259,212553,0,959,214862,212553,g,6345
6346,211099,879,1181,0,2731,215890,211099,a,6346
6347,213370,1158,1216,0,786,216530,213370,a,6347
6348,1857,419,2508,0,211883,216667,211883,t,6348
6349,697,457,2199,0,216275,219628,216275,t,6349
6350,1911,214669,2130,0,1645,220355,214669,c,6350
6351,215774,708,1458,0,1931,219871,215774,a,6351
6352,216937,1315,715,0,2150,221117,216937,a,6352
6353,2816,354,217641,0,353,221164,217641,g,6353
6354,1041,222,213731,0,1017,216011,213731,g,6354
6355,212547,1527,889,0,1603,216566,212547,a,6355
6356,969,218,215299,0,404,216890,215299,g,6356
6357,1900,1283,1092,0,212265,216540,212265,t,6357
6358,506,553,3392,0,211986,216437,211986,t,6358
6359,481,1192,907,0,213828,216408,213828,t,6359
6360,1731,1035,212615,0,761,216142,212615,g,6360
6361,1430,210208,2807,0,954,215399,210208,c,6361
6362,212449,742,542,0,1165,214898,212449,a,6362
6363,621,214,211888,0,3300,216023,211888,g,6363
6364,1496,208803,419,0,1673,212391,208803,c,6364
6365,1115,970,883,0,209222,212190,209222,t,6365
6366,300,1083,210407,0,1706,213496,210407,g,6366
6367,585,188,211251,0,1089,213113,211251,g,6367
6368,207705,1014,1509,0,1206,211434,207705,a,6368
6369,208327,1038,931,0,2234,212530,208327,a,6369
6370,733,185,211621,0,804,213343,211621,g,6370
6371,210075,1082,683,0,944,212784,210075,a,6371
6372,209147,1168,2060,0,733,213108,209147,a,6372
6373,209856,2326,308,0,2411,214901,209856,a,6373
6374,426,179,214330,0,425,215360,214330,g,6374
6375,1156,664,488,0,213628,215936,213628,t,6375
6376,1462,214026,737,0,3199,219424,214026,c,6376
6377,1368,216752,1468,0,2344,221932,216752,c,6377
6378,1707,215118,990,0,947,218762,215118,c,6378
6379,1950,486,1611,0,211864,215911,211864,t,6379
6380,694,397,212686,0,619,214396,212686,g,6380
6381,207979,875,640,0,808,210302,207979,a,6381
6382,1576,204526,1273,0,4650,212025,204526,c,6382
6383,1755,206635,702,0,2263,211355,206635,c,6383
6384,1511,207370,2236,0,741,211858,207370,c,6384
6385,1283,305,1732,0,208459,211779,208459,t,6385
6386,521,227,210713,0,400,211861,210713,g,6386
6387,208848,862,500,0,1493,211703,208848,a,6387
6388,208856,820,1386,0,1629,212691,208856,a,6388
6389,911,209397,1969,0,1231,213508,209397,c,6389
6390,1749,207194,2844,0,800,212587,207194,c,6390
6391,379,174,2006,0,209840,212399,209840,t,6391
6392,209236,2341,475,0,731,212783,209236,a,6392
6393,209402,872,2149,0,467,212890,209402,a,6393
6394,1102,272,619,0,212874,214867,212874,t,6394
6395,1548,208443,1690,0,1571,213252,208443,c,6395
6396,210458,616,716,0,3536,215326,210458,a,6396
6397,1316,211519,2332,0,1140,216307,211519,c,6397
6398,212094,554,2668,0,1196,216512,212094,a,6398
6399,284,98,216113,0,581,217076,216113,g,6399
6400,212956,1030,792,0,604,215382,212956,a,6400
6401,212124,968,1287,0,876,215255,212124,a,6401
6402,211498,1848,1043,0,790,215179,211498,a,6402
6403,1863,561,916,0,212391,215731,212391,t,6403
6404,729,1360,213449,0,769,216307,213449,g,6404
6405,635,470,213140,0,2330,216575,213140,g,6405
6406,416,237,215523,0,1324,217500,215523,g,6406
6407,1712,389,559,0,214165,216825,214165,t,6407
6408,213541,1125,1151,0,695,216512,213541,a,6408
6409,565,216,215077,0,444,216302,215077,g,6409
6410,1279,318,213546,0,975,216118,213546,g,6410
6411,1316,212284,989,0,1548,216137,212284,c,6411
6412,962,810,1248,0,213238,216258,213238,t,6412
6413,635,194,339,0,217615,218783,217615,t,6413
6414,1406,217366,544,0,1992,221308,217366,c,6414
6415,1731,218171,1372,0,687,221961,218171,c,6415
6416,219460,576,1124,0,480,221640,219460,a,6416
6417,218695,1122,874,0,1322,222013,218695,a,6417
6418,1013,219416,949,0,1152,222530,219416,c,6418
6419,576,258,679,0,220857,222370,220857,t,6419
6420,285,312,732,0,221106,222435,221106,t,6420
6421,382,181,626,0,221887,223076,221887,t,6421
6422,844,221188,674,0,743,223449,221188,c,6422
6423,219763,963,938,0,694,222358,219763,a,6423
6424,762,239,413,0,219071,220485,219071,t,6424
6425,498,253,218921,0,414,220086,218921,g,6425
6426,216374,1023,358,0,1170,218925,216374,a,6426
6427,1263,216470,506,0,701,218940,216470,c,6427
6428,522,584,489,0,219092,220687,219092,t,6428
6429,894,219616,492,0,896,221898,219616,c,6429
6430,218973,1165,1332,0,474,221944,218973,a,6430
6431,682,227,219234,0,592,220735,219234,g,6431
6432,216446,1384,420,0,2967,221217,216446,a,6432
6433,218932,1572,608,0,3205,224317,218932,a,6433
6434,629,852,222605,0,1680,225766,222605,g,6434
6435,1018,355,221171,0,1572,224116,221171,g,6435
6436,1605,219299,1939,0,865,223708,219299,c,6436
6437,220322,1029,657,0,783,222791,220322,a,6437
6438,220219,1154,374,0,875,222622,220219,a,6438
6439,1030,518,220355,0,491,222394,220355,g,6439
6440,212996,1417,781,0,2053,217247,212996,a,6440
6441,1095,375,216069,0,580,218119,216069,g,6441
6442,212679,1284,369,0,1814,216146,212679,a,6442
6443,1897,212705,713,0,1400,216715,212705,c,6443
6444,965,267,214699,0,1897,217828,214699,g,6444
6445,2064,210450,2615,0,2342,217471,210450,c,6445
6446,209167,2349,1973,0,1800,215289,209167,a,6446
6447,2202,206648,2509,0,3341,214700,206648,c,6447
6448,2018,1577,3017,0,211809,218421,211809,t,6448
6449,881,617,218767,0,855,221120,218767,g,6449
6450,2597,315,215264,0,1794,219970,215264,g,6450
6451,214495,1359,1392,0,1437,218683,214495,a,6451
6452,2821,211106,3930,0,1139,218996,211106,c,6452
6453,209685,1197,1357,0,1274,213513,209685,a,6453
6454,206281,1217,4011,0,5380,216889,206281,a,6454
6455,2577,212530,2067,0,599,217773,212530,c,6455
6456,1381,254,2926,0,212006,216567,212006,t,6456
6457,646,1891,1525,0,211775,215837,211775,t,6457
6458,211510,1637,1954,0,621,215722,211510,a,6458
6459,1907,622,212671,0,654,215854,212671,g,6459
6460,2366,209343,2159,0,1710,215578,209343,c,6460
6461,212670,1021,1164,0,806,215661,212670,a,6461
6462,386,201,214815,0,472,215874,214815,g,6462
6463,2373,637,520,0,212076,215606,212076,t,6463
6464,387,378,214085,0,924,215774,214085,g,6464
6465,993,210597,979,0,2615,215184,210597,c,6465
6466,2291,590,1041,0,210869,214791,210869,t,6466
6467,422,383,212949,0,1286,215040,212949,g,6467
6468,2507,210161,1004,0,1403,215075,210161,c,6468
6469,210725,1102,1484,0,6676,219987,210725,a,6469
6470,1812,218741,858,0,1015,222426,218741,c,6470
6471,218365,984,717,0,1876,221942,218365,a,6471
6472,1638,218319,1143,0,1801,222901,218319,c,6472
6473,1388,429,220180,0,1620,223617,220180,g,6473
6474,1531,308,221099,0,1311,224249,221099,g,6474
6475,1455,219129,1749,0,1433,223766,219129,c,6475
6476,2418,959,2558,0,212336,218271,212336,t,6476
6477,756,372,214670,0,723,216521,214670,g,6477
6478,210419,1137,685,0,3752,215993,210419,a,6478
6479,213830,1430,803,0,1310,217373,213830,a,6479
6480,966,447,215054,0,1494,217961,215054,g,6480
6481,3117,209747,976,0,1380,215220,209747,c,6481
6482,210245,1654,2626,0,1119,215644,210245,a,6482
6483,1013,1459,211422,0,1697,215591,211422,g,6483
6484,1525,365,210728,0,1145,213763,210728,g,6484
6485,2792,3357,1949,0,201616,209714,201616,t,6485
6486,956,753,207055,0,763,209527,207055,g,6486
6487,1610,333,205757,0,858,208558,205757,g,6487
6488,204763,1681,594,0,1362,208400,204763,a,6488
6489,204830,1828,962,0,928,208548,204830,a,6489
6490,759,579,205862,0,2064,209264,205862,g,6490
6491,5821,489,199300,0,1233,206843,199300,g,6491
6492,773,446,203794,0,5459,210472,203794,g,6492
6493,1564,206749,603,0,8865,217781,206749,c,6493
6494,915,392,217756,0,941,220004,217756,g,6494
6495,1999,727,2573,0,210815,216114,210815,t,6495
6496,211589,1688,1281,0,2574,217132,211589,a,6496
6497,3640,208827,4538,0,927,217932,208827,c,6497
6498,212223,798,3270,0,1247,217538,212223,a,6498
6499,211557,1378,2943,0,1527,217405,211557,a,6499
6500,1221,393,3060,0,213254,217928,213254,t,6500
6501,1720,213120,2332,0,1298,218470,213120,c,6501
6502,211516,992,3638,0,2378,218524,211516,a,6502
6503,2659,502,1356,0,213509,218026,213509,t,6503
6504,489,1887,214878,0,1676,218930,214878,g,6504
6505,3641,209350,3076,0,1097,217164,209350,c,6505
6506,1178,872,1696,0,213070,216816,213070,t,6506
6507,1787,211908,2160,0,799,216654,211908,c,6507
6508,875,340,1169,0,214204,216588,214204,t,6508
6509,1502,212265,1278,0,1206,216251,212265,c,6509
6510,212775,1386,2302,0,1763,218226,212775,a,6510
6511,355,457,217484,0,543,218839,217484,g,6511
6512,1384,924,2520,0,213177,218005,213177,t,6512
6513,672,277,214304,0,445,215698,214304,g,6513
6514,211269,1158,1468,0,956,214851,211269,a,6514
6515,211719,1166,455,0,1705,215045,211719,a,6515
6516,1807,211586,1412,0,373,215178,211586,c,6516
6517,980,360,1615,0,211482,214437,211482,t,6517
6518,1123,374,212238,0,1590,215325,212238,g,6518
6519,1259,212304,1011,0,3165,217739,212304,c,6519
6520,1519,215445,597,0,1270,218831,215445,c,6520
6521,411,251,217012,0,332,218006,217012,g,6521
6522,1654,363,209936,0,1356,213309,209936,g,6522
6523,207023,1546,358,0,349,209276,207023,a,6523
6524,1104,311,207356,0,406,209177,207356,g,6524
6525,206425,1247,477,0,577,208726,206425,a,6525
6526,980,203997,1615,0,3624,210216,203997,c,6526
6527,1587,206974,312,0,4137,213010,206974,c,6527
6528,991,210214,2141,0,5217,218563,210214,c,6528
6529,454,1061,1236,0,219818,222569,219818,t,6529
6530,636,564,220700,0,2354,224254,220700,g,6530
6531,1152,235,220072,0,1968,223427,220072,g,6531
6532,214498,1530,859,0,927,217814,214498,a,6532
6533,1286,236,215441,0,349,217312,215441,g,6533
6534,211068,1431,1259,0,881,214639,211068,a,6534
6535,1785,208354,3053,0,2834,216026,208354,c,6535
6536,213017,1748,1166,0,292,216223,213017,a,6536
6537,695,439,2940,0,211446,215520,211446,t,6537
6538,1797,2317,603,0,210808,215525,210808,t,6538
6539,400,357,213667,0,3549,217973,213667,g,6539
6540,1182,215629,833,0,1257,218901,215629,c,6540
6541,703,349,3301,0,213923,218276,213923,t,6541
6542,537,366,752,0,215586,217241,215586,t,6542
6543,1068,605,2524,0,211007,215204,211007,t,6543
6544,529,257,1335,0,211623,213744,211623,t,6544
6545,210336,735,570,0,1033,212674,210336,a,6545
6546,819,208020,2778,0,1031,212648,208020,c,6546
6547,1091,519,2815,0,205629,210054,205629,t,6547
6548,415,197,208161,0,292,209065,208161,g,6548
6549,206097,1213,717,0,592,208619,206097,a,6549
6550,2469,203022,1051,0,906,207448,203022,c,6550
6551,202627,1429,1291,0,2004,207351,202627,a,6551
6552,1044,203128,2270,0,874,207316,203128,c,6552
6553,1855,472,2179,0,202375,206881,202375,t,6553
6554,457,297,667,0,206112,207533,206112,t,6554
6555,1148,204485,1426,0,645,207704,204485,c,6555
6556,459,315,1791,0,204771,207336,204771,t,6556
6557,1406,945,203379,0,1120,206850,203379,g,6557
6558,1040,382,200291,0,1238,202951,200291,g,6558
6559,2869,195203,2295,0,938,201305,195203,c,6559
6560,1974,394,1949,0,192213,196530,192213,t,6560
6561,193289,992,1141,0,958,196380,193289,a,6561
6562,870,190321,3698,0,1266,196155,190321,c,6562
6563,191464,2819,846,0,836,195965,191464,a,6563
6564,333,202,194113,0,350,194998,194113,g,6564
6565,851,964,1215,0,192523,195553,192523,t,6565
6566,1551,191625,1772,0,680,195628,191625,c,6566
6567,190740,1103,1854,0,2349,196046,190740,a,6567
6568,1302,190981,1985,0,1746,196014,190981,c,6568
6569,188084,1454,1598,0,1472,192608,188084,a,6569
6570,1041,261,188726,0,2440,192468,188726,g,6570
6571,1414,357,188851,0,1354,191976,188851,g,6571
6572,187081,1868,1200,0,2461,192610,187081,a,6572
6573,1183,527,190584,0,1533,193827,190584,g,6573
6574,661,437,191211,0,956,193265,191211,g,6574
6575,189869,1255,1236,0,1151,193511,189869,a,6575
6576,189834,1113,1216,0,651,192814,189834,a,6576
6577,958,318,1033,0,190068,192377,190068,t,6577
6578,1112,188902,1281,0,1679,192974,188902,c,6578
6579,670,219,1731,0,192270,194890,192270,t,6579
6580,394,582,985,0,194306,196267,194306,t,6580
6581,217,383,1468,0,194858,196926,194858,t,6581
6582,519,184,1223,0,195214,197140,195214,t,6582
6583,596,193,602,0,196813,198204,196813,t,6583
6584,196144,678,1005,0,890,198717,196144,a,6584
6585,873,167,1002,0,196964,199006,196964,t,6585
6586,539,193,501,0,198748,199981,198748,t,6586
6587,732,197979,760,0,894,200365,197979,c,6587
6588,234,334,739,0,198888,200195,198888,t,6588
6589,509,816,799,0,197799,199923,197799,t,6589
6590,375,179,198496,0,405,199455,198496,g,6590
6591,194208,1038,988,0,539,196773,194208,a,6591
6592,1009,303,293,0,194300,195905,194300,t,6592
6593,303,291,193459,0,428,194481,193459,g,6593
6594,191809,1147,788,0,628,194372,191809,a,6594
6595,354,395,190763,0,2613,194125,190763,g,6595
6596,655,190985,273,0,1478,193391,190985,c,6596
6597,432,142,191783,0,483,192840,191783,g,6597
6598,532,255,184706,0,715,186208,184706,g,6598
6599,180416,1208,533,0,851,183008,180416,a,6599
6600,180101,1673,469,0,893,183136,180101,a,6600
6601,486,380,181008,0,868,182742,181008,g,6601
6602,4415,1364,174572,0,1129,181480,174572,g,6602
6603,391,762,179649,0,857,181659,179649,g,6603
6604,945,366,179170,0,613,181094,179170,g,6604
6605,1963,1718,975,0,175957,180613,175957,t,6605
6606,171808,937,5561,0,723,179029,171808,a,6606
6607,293,270,1711,0,176535,178809,176535,t,6607
6608,175988,1082,263,0,6598,183931,175988,a,6608
6609,278,1192,184792,0,7040,193302,184792,g,6609
6610,525,607,194232,0,1241,196605,194232,g,6610
6611,484,226,194560,0,661,195931,194560,g,6611
6612,192489,1063,606,0,2363,196521,192489,a,6612
6613,194572,1001,640,0,1268,197481,194572,a,6613
6614,705,208,195705,0,510,197128,195705,g,6614
6615,191276,967,792,0,1693,194728,191276,a,6615
6616,2086,407,2366,0,189750,194609,189750,t,6616
6617,793,3161,189685,0,722,194361,189685,g,6617
6618,187118,729,2585,0,3539,193971,187118,a,6618
6619,1884,187100,1542,0,5771,196297,187100,c,6619
6620,1459,190398,2695,0,3759,198311,190398,c,6620
6621,1244,191161,4187,0,2809,199401,191161,c,6621
6622,574,1295,460,0,196440,198769,196440,t,6622
6623,510,1669,195995,0,841,199015,195995,g,6623
6624,482,344,196463,0,1034,198323,196463,g,6624
6625,688,263,193661,0,1518,196130,193661,g,6625
6626,189551,1551,1142,0,1536,193780,189551,a,6626
6627,189541,1186,1809,0,1059,193595,189541,a,6627
6628,2404,813,1114,0,190747,195078,190747,t,6628
6629,440,779,192425,0,1480,195124,192425,g,6629
6630,2532,1157,985,0,191211,195885,191211,t,6630
6631,762,750,193889,0,1519,196920,193889,g,6631
6632,1157,190648,1392,0,2082,195279,190648,c,6632
6633,993,951,1237,0,192306,195487,192306,t,6633
6634,591,289,192025,0,960,193865,192025,g,6634
6635,1148,187369,905,0,2632,192054,187369,c,6635
6636,188082,555,1408,0,737,190782,188082,a,6636
6637,361,179,1442,0,187606,189588,187606,t,6637
6638,187413,742,1281,0,871,190307,187413,a,6638
6639,187277,994,1042,0,762,190075,187277,a,6639
6640,504,360,1100,0,188843,190807,188843,t,6640
6641,1387,187413,910,0,891,190601,187413,c,6641
6642,186497,854,1179,0,2113,190643,186497,a,6642
6643,998,187794,695,0,1566,191053,187794,c,6643
6644,793,162,188823,0,749,190527,188823,g,6644
6645,699,198,185824,0,2984,189705,185824,g,6645
6646,2651,181084,904,0,2185,186824,181084,c,6646
6647,995,395,1485,0,180411,183286,180411,t,6647
6648,178561,2320,849,0,1552,183282,178561,a,6648
6649,678,241,180478,0,775,182172,180478,g,6649
6650,1882,580,3141,0,176368,181971,176368,t,6650
6651,178813,1175,891,0,1065,181944,178813,a,6651
6652,2196,233,1261,0,177872,181562,177872,t,6652
6653,457,194,1627,0,182295,184573,182295,t,6653
6654,2761,180425,596,0,2271,186053,180425,c,6654
6655,811,554,2280,0,183461,187106,183461,t,6655
6656,1309,184339,367,0,2269,188284,184339,c,6656
6657,1347,182897,2765,0,749,187758,182897,c,6657
6658,526,281,1388,0,183131,185326,183131,t,6658
6659,180918,2691,550,0,1071,185230,180918,a,6659
6660,553,311,2544,0,181775,185183,181775,t,6660
6661,441,1037,181339,0,2352,185169,181339,g,6661
6662,458,310,183659,0,408,184835,183659,g,6662
6663,1870,595,1623,0,180319,184407,180319,t,6663
6664,181707,1251,356,0,2416,185730,181707,a,6664
6665,2834,180972,2062,0,736,186604,180972,c,6665
6666,631,402,184215,0,7537,192785,184215,g,6666
6667,2094,191143,2070,0,687,195994,191143,c,6667
6668,190578,2634,1280,0,2170,196662,190578,a,6668
6669,3097,192518,803,0,799,197217,192518,c,6669
6670,191148,1490,1080,0,832,194550,191148,a,6670
6671,191158,1011,1664,0,865,194698,191158,a,6671
6672,191537,1200,1424,0,582,194743,191537,a,6672
6673,1122,202,860,0,192140,194324,192140,t,6673
6674,189249,879,1228,0,2137,193493,189249,a,6674
6675,1727,188780,2377,0,1252,194136,188780,c,6675
6676,189806,1716,830,0,1455,193807,189806,a,6676
6677,1592,363,188746,0,1703,192404,188746,g,6677
6678,3670,179457,892,0,1678,185697,179457,c,6678
6679,4683,168131,3030,0,731,176575,168131,c,6679
6680,168520,1450,3429,0,2155,175554,168520,a,6680
6681,4738,166168,2565,0,1030,174501,166168,c,6681
6682,166399,2051,1317,0,6958,176725,166399,a,6682
6683,2016,170795,2078,0,2201,177090,170795,c,6683
6684,1458,1748,6338,0,167267,176811,167267,t,6684
6685,671,451,175148,0,696,176966,175148,g,6685
6686,5830,619,168523,0,1095,176067,168523,g,6686
6687,171077,1770,1285,0,579,174711,171077,a,6687
6688,2578,897,7028,0,165593,176096,165593,t,6688
6689,173107,1488,502,0,1320,176417,173107,a,6689
6690,1823,442,173192,0,2117,177574,173192,g,6690
6691,2219,172685,1440,0,952,177296,172685,c,6691
6692,168309,1783,6214,0,476,176782,168309,a,6692
6693,1158,507,168327,0,7017,177009,168327,g,6693
6694,2801,162851,1238,0,962,167852,162851,c,6694
6695,1590,880,8481,0,156184,167135,156184,t,6695
6696,1493,483,580,0,164732,167288,164732,t,6696
6697,1339,159966,5039,0,1397,167741,159966,c,6697
6698,157807,2830,2165,0,4650,167452,157807,a,6698
6699,162962,1038,2571,0,1007,167578,162962,a,6699
6700,3875,476,4432,0,158998,167781,158998,t,6700
6701,164499,1282,910,0,499,167190,164499,a,6701
6702,163631,852,1884,0,495,166862,163631,a,6702
6703,1650,581,6238,0,158232,166701,158232,t,6703
6704,162990,1492,829,0,1444,166755,162990,a,6704
6705,2177,156963,6766,0,773,166679,156963,c,6705
6706,1496,1666,1474,0,159351,163987,159351,t,6706
6707,855,493,162324,0,693,164365,162324,g,6707
6708,854,336,157559,0,5270,164019,157559,g,6708
6709,159599,2410,758,0,4703,167470,159599,a,6709
6710,1144,250,167234,0,655,169283,167234,g,6710
6711,4643,954,1337,0,160702,167636,160702,t,6711
6712,950,335,2505,0,163965,167755,163965,t,6712
6713,1139,3074,789,0,162495,167497,162495,t,6713
6714,1594,905,828,0,163867,167194,163867,t,6714
6715,1064,2328,2104,0,161411,166907,161411,t,6715
6716,409,223,3402,0,163523,167557,163523,t,6716
6717,1260,162566,3326,0,704,167856,162566,c,6717
6718,1154,384,1173,0,165898,168609,165898,t,6718
6719,2008,164808,1476,0,694,168986,164808,c,6719
6720,164385,1480,2235,0,224,168324,164385,a,6720
6721,764,360,1755,0,165126,168005,165126,t,6721
6722,165440,1677,356,0,1449,168922,165440,a,6722
6723,760,285,167994,0,400,169439,167994,g,6723
6724,952,864,987,0,166365,169168,166365,t,6724
6725,347,427,1370,0,166867,169011,166867,t,6725
6726,318,268,429,0,167944,168959,167944,t,6726
6727,1025,160,251,0,168104,169540,168104,t,6727
6728,418,247,167548,0,1528,169741,167548,g,6728
6729,1158,167282,314,0,325,169079,167282,c,6729
6730,295,159,247,0,167818,168519,167818,t,6730
6731,198,237,160,0,167600,168195,167600,t,6731
6732,166864,710,117,0,417,168108,166864,a,6732
6733,336,178,231,0,167620,168365,167620,t,6733
6734,211,179,176,0,169265,169831,169265,t,6734
6735,931,169196,269,0,2178,172574,169196,c,6735
6736,929,171949,256,0,474,173608,171949,c,6736
6737,171624,1319,215,0,965,174123,171624,a,6737
6738,613,222,173359,0,639,174833,173359,g,6738
6739,172239,1129,226,0,555,174149,172239,a,6739
6740,172629,599,271,0,844,174343,172629,a,6740
6741,1476,172194,140,0,3010,176820,172194,c,6741
6742,1200,176230,154,0,1480,179064,176230,c,6742
6743,178203,844,499,0,2213,181759,178203,a,6743
6744,673,181,181832,0,544,183230,181832,g,6744
6745,181260,1105,347,0,1564,184276,181260,a,6745
6746,183526,858,226,0,939,185549,183526,a,6746
6747,183911,867,640,0,1508,186926,183911,a,6747
6748,186160,866,187,0,1882,189095,186160,a,6748
6749,997,313,188158,0,2444,191912,188158,g,6749
6750,1547,190093,249,0,2597,194486,190093,c,6750
6751,193665,992,490,0,932,196079,193665,a,6751
6752,932,271,193021,0,1515,195739,193021,g,6752
6753,191177,1119,552,0,2668,195516,191177,a,6753
6754,1400,413,194330,0,1054,197197,194330,g,6754
6755,191930,1026,469,0,688,194113,191930,a,6755
6756,192162,652,639,0,934,194387,192162,a,6756
6757,2323,189957,1469,0,571,194320,189957,c,6757
6758,186016,1596,1217,0,2267,191096,186016,a,6758
6759,1813,186728,1655,0,2605,192801,186728,c,6759
6760,2073,186881,918,0,2615,192487,186881,c,6760
6761,1675,185567,2651,0,1890,191783,185567,c,6761
6762,2103,177634,3520,0,1675,184932,177634,c,6762
6763,175317,1647,1172,0,1764,179900,175317,a,6763
6764,177827,1133,1244,0,1021,181225,177827,a,6764
6765,1369,642,178296,0,1110,181417,178296,g,6765
6766,175647,1387,1450,0,990,179474,175647,a,6766
6767,1238,367,3187,0,177539,182331,177539,t,6767
6768,177975,2478,884,0,914,182251,177975,a,6768
6769,175378,774,4415,0,1625,182192,175378,a,6769
6770,2754,173556,3449,0,2453,182212,173556,c,6770
6771,3214,170758,4165,0,2951,181088,170758,c,6771
6772,175616,985,3452,0,2090,182143,175616,a,6772
6773,176456,1567,1959,0,1423,181405,176456,a,6773
6774,1303,412,2515,0,176655,180885,176655,t,6774
6775,3957,1367,1909,0,173647,180880,173647,t,6775
6776,1085,690,176883,0,1611,180269,176883,g,6776
6777,173639,1333,1716,0,2951,179639,173639,a,6777
6778,2768,171262,2671,0,3724,180425,171262,c,6778
6779,3253,169095,2350,0,1381,176079,169095,c,6779
6780,1900,458,3228,0,168265,173851,168265,t,6780
6781,166061,2753,2623,0,2986,174423,166061,a,6781
6782,1469,168261,3146,0,3148,176024,168261,c,6782
6783,1388,594,173474,0,861,176317,173474,g,6783
6784,1303,507,1753,0,171981,175544,171981,t,6784
6785,979,2207,3886,0,170188,177260,170188,t,6785
6786,796,417,174652,0,1733,177598,174652,g,6786
6787,2571,482,1543,0,173240,177836,173240,t,6787
6788,3966,170384,2240,0,997,177587,170384,c,6788
6789,172822,1000,1464,0,1364,176650,172822,a,6789
6790,2114,636,3955,0,166385,173090,166385,t,6790
6791,169711,1142,983,0,3291,175127,169711,a,6791
6792,3028,936,170516,0,1494,175974,170516,g,6792
6793,2836,166836,1646,0,3995,175313,166836,c,6793
6794,2220,167300,4265,0,1300,175085,167300,c,6794
6795,169594,1296,1265,0,2997,175152,169594,a,6795
6796,3366,357,1189,0,171087,175999,171087,t,6796
6797,1894,170444,2802,0,3367,178507,170444,c,6797
6798,3960,171454,2420,0,1142,178976,171454,c,6798
6799,1150,429,1891,0,175459,178929,175459,t,6799
6800,2819,173692,1075,0,1338,178924,173692,c,6800
6801,172208,1637,753,0,5927,180525,172208,a,6801
6802,1815,175735,2126,0,1697,181373,175735,c,6802
6803,175076,2113,2489,0,1834,181512,175076,a,6803
6804,773,463,178465,0,1826,181527,178465,g,6804
6805,1983,1559,900,0,177247,181689,177247,t,6805
6806,739,1228,177704,0,2744,182415,177704,g,6806
6807,765,444,178799,0,2381,182389,178799,g,6807
6808,2545,1342,1423,0,176637,181947,176637,t,6808
6809,921,3198,175471,0,1579,181169,175471,g,6809
6810,2876,586,175116,0,5768,184346,175116,g,6810
6811,5090,180222,452,0,3251,189015,180222,c,6811
6812,1789,185647,2491,0,629,190556,185647,c,6812
6813,560,1642,187643,0,809,190654,187643,g,6813
6814,3609,185489,1009,0,523,190630,185489,c,6814
6815,187960,1197,1160,0,265,190582,187960,a,6815
6816,188878,948,276,0,490,190592,188878,a,6816
6817,4012,185882,327,0,334,190555,185882,c,6817
6818,1496,185967,2475,0,343,190281,185967,c,6818
6819,187727,1655,313,0,1626,191321,187727,a,6819
6820,869,2192,865,0,188205,192131,188205,t,6820
6821,579,395,190182,0,865,192021,190182,g,6821
6822,574,475,190331,0,605,191985,190331,g,6822
6823,1441,189646,228,0,764,192079,189646,c,6823
6824,189639,1399,298,0,667,192003,189639,a,6824
6825,187703,1494,649,0,2520,192366,187703,a,6825
6826,189947,1724,297,0,876,192844,189947,a,6826
6827,1584,190342,486,0,814,193226,190342,c,6827
6828,514,670,190455,0,575,192214,190455,g,6828
6829,188402,2211,896,0,1243,192752,188402,a,6829
6830,1019,452,190999,0,911,193381,190999,g,6830
6831,186737,1868,582,0,2222,191409,186737,a,6831
6832,1679,421,721,0,189242,192063,189242,t,6832
6833,705,849,189526,0,847,191927,189526,g,6833
6834,1737,495,189569,0,3504,195305,189569,g,6834
6835,528,365,194923,0,1220,197036,194923,g,6835
6836,1998,2416,1193,0,191443,197050,191443,t,6836
6837,670,330,1997,0,194322,197319,194322,t,6837
6838,504,282,686,0,196256,197728,196256,t,6838
6839,1682,194285,507,0,2052,198526,194285,c,6839
6840,1919,192538,2308,0,2077,198842,192538,c,6840
6841,549,365,975,0,196153,198042,196153,t,6841
6842,873,618,194063,0,3277,198831,194063,g,6842
6843,3028,597,193363,0,2284,199272,193363,g,6843
6844,193869,2157,1664,0,1107,198797,193869,a,6844
6845,193547,1789,2370,0,1340,199046,193547,a,6845
6846,193779,1651,2200,0,1297,198927,193779,a,6846
6847,192836,1532,3399,0,1315,199082,192836,a,6847
6848,194567,1884,1787,0,1102,199340,194567,a,6848
6849,193164,2396,2315,0,1509,199384,193164,a,6849
6850,3135,193254,1761,0,1423,199573,193254,c,6850
6851,2466,614,180073,0,859,184012,180073,g,6851
6852,176235,1941,3161,0,2097,183434,176235,a,6852
6853,173677,4397,2835,0,4830,185739,173677,a,6853
6854,1361,866,181811,0,2457,186495,181811,g,6854
6855,175068,1989,7042,0,2260,186359,175068,a,6855
6856,178568,2079,3049,0,2597,186293,178568,a,6856
6857,180183,2455,2339,0,1389,186366,180183,a,6857
6858,1470,786,182765,0,2325,187346,182765,g,6858
6859,179283,2656,1538,0,3494,186971,179283,a,6859
6860,1070,1326,5539,0,184036,191971,184036,t,6860
6861,2109,187286,1587,0,4979,195961,187286,c,6861
6862,1536,995,1564,0,192232,196327,192232,t,6862
6863,2030,190179,2088,0,2874,197171,190179,c,6863
6864,785,1077,194273,0,1120,197255,194273,g,6864
6865,1097,458,188932,0,5370,195857,188932,g,6865
6866,178690,2640,5877,0,5414,192621,178690,a,6866
6867,1243,507,1811,0,187665,191226,187665,t,6867
6868,4607,993,1123,0,184775,191498,184775,t,6868
6869,697,1500,186856,0,2394,191447,186856,g,6869
6870,1071,1203,187822,0,1806,191902,187822,g,6870
6871,1241,693,188462,0,2719,193115,188462,g,6871
6872,185328,2516,1485,0,3245,192574,185328,a,6872
6873,186485,1780,2415,0,3049,193729,186485,a,6873
6874,3579,679,187162,0,2748,194168,187162,g,6874
6875,2701,182985,5121,0,3744,194551,182985,c,6875
6876,187169,1220,2825,0,4712,195926,187169,a,6876
6877,487,486,3580,0,191436,195989,191436,t,6877
6878,811,557,1257,0,192930,195555,192930,t,6878
6879,187620,1778,3052,0,2693,195143,187620,a,6879
6880,2383,186184,4134,0,2029,194730,186184,c,6880
6881,188976,1156,1839,0,1527,193498,188976,a,6881
6882,184281,1813,2776,0,4406,193276,184281,a,6882
6883,2744,185288,1053,0,3418,192503,185288,c,6883
6884,2615,183096,1204,0,5264,192179,183096,c,6884
6885,2312,186402,1861,0,2102,192677,186402,c,6885
6886,185789,2135,2428,0,2085,192437,185789,a,6886
6887,1235,652,189077,0,1457,192421,189077,g,6887
6888,3259,182542,1542,0,2926,190269,182542,c,6888
6889,183342,1678,2622,0,2109,189751,183342,a,6889
6890,182924,1973,1837,0,5243,191977,182924,a,6890
6891,1982,186664,1143,0,6774,196563,186664,c,6891
6892,1985,193141,1698,0,3033,199857,193141,c,6892
6893,1703,194860,2291,0,1952,200806,194860,c,6893
6894,1067,576,197905,0,1003,200551,197905,g,6894
6895,195984,2009,833,0,2421,201247,195984,a,6895
6896,2449,953,196474,0,1940,201816,196474,g,6896
6897,195200,2137,1663,0,4081,203081,195200,a,6897
6898,1167,980,200102,0,2869,205118,200102,g,6898
6899,2243,201088,923,0,1362,205616,201088,c,6899
6900,201231,1213,1919,0,1262,205625,201231,a,6900
6901,201129,1294,1214,0,2120,205757,201129,a,6901
6902,2000,200566,1199,0,2063,205828,200566,c,6902
6903,197854,1844,1445,0,3432,204575,197854,a,6903
6904,1106,655,983,0,202921,205665,202921,t,6904
6905,2112,201095,1453,0,2965,207625,201095,c,6905
6906,2074,200029,1781,0,4369,208253,200029,c,6906
6907,1978,2822,2262,0,199785,206847,199785,t,6907
6908,1312,743,201412,0,1267,204734,201412,g,6908
6909,1812,832,192289,0,1288,196221,192289,g,6909
6910,168698,2034,1951,0,4188,176871,168698,a,6910
6911,3144,162950,9704,0,1909,177707,162950,c,6911
6912,165815,1549,1697,0,3671,172732,165815,a,6912
6913,2165,830,2286,0,167442,172723,167442,t,6913
6914,167391,2470,2217,0,2476,174554,167391,a,6914
6915,1240,604,172324,0,3185,177353,172324,g,6915
6916,170708,1558,2399,0,4555,179220,170708,a,6916
6917,3404,663,8652,0,167582,180301,167582,t,6917
6918,2404,169921,3107,0,5286,180718,169921,c,6918
6919,2644,897,8572,0,167842,179955,167842,t,6919
6920,164379,2738,3402,0,9354,179873,164379,a,6920
6921,1737,173111,2600,0,3001,180449,173111,c,6921
6922,1510,413,174275,0,2588,178786,174275,g,6922
6923,1988,838,2519,0,165642,170987,165642,t,6923
6924,4617,155886,8067,0,2329,170899,155886,c,6924
6925,2651,152268,6296,0,9710,170925,152268,c,6925
6926,7437,155396,4568,0,3635,171036,155396,c,6926
6927,1193,789,166422,0,1899,170303,166422,g,6927
6928,4196,152012,8671,0,4577,169456,152012,c,6928
6929,157067,1418,6425,0,4016,168926,157067,a,6929
6930,9953,849,2439,0,156153,169394,156153,t,6930
6931,6302,154829,7067,0,2267,170465,154829,c,6931
6932,163147,2041,2948,0,3000,171136,163147,a,6932
6933,1881,1152,166932,0,2120,172085,166932,g,6933
6934,6324,157716,3468,0,4765,172273,157716,c,6934
6935,156598,1849,9776,0,3891,172114,156598,a,6935
6936,1989,800,3796,0,167274,173859,167274,t,6936
6937,4294,1549,167770,0,2178,175791,167770,g,6937
6938,1693,754,168108,0,4574,175129,168108,g,6938
6939,166691,2880,1643,0,3182,174396,166691,a,6939
6940,4226,161838,4005,0,3030,173099,161838,c,6940
6941,2856,1657,164441,0,3947,172901,164441,g,6941
6942,4091,158789,3906,0,5465,172251,158789,c,6942
6943,1656,2225,2677,0,165506,172064,165506,t,6943
6944,1201,1918,164438,0,4135,171692,164438,g,6944
6945,1515,842,2802,0,165727,170886,165727,t,6945
6946,160530,2275,2385,0,5027,170217,160530,a,6946
6947,1571,1296,3095,0,164212,170174,164212,t,6947
6948,1360,823,165338,0,2570,170091,165338,g,6948
6949,2000,159795,2213,0,5820,169828,159795,c,6949
6950,1314,1181,2417,0,165068,169980,165068,t,6950
6951,556,996,164450,0,3878,169880,164450,g,6951
6952,1307,715,1541,0,165800,169363,165800,t,6952
6953,990,1378,164865,0,1685,168918,164865,g,6953
6954,1324,976,163465,0,2297,168062,163465,g,6954
6955,1772,160903,1502,0,3064,167241,160903,c,6955
6956,1951,160574,2380,0,2368,167273,160574,c,6956
6957,160457,1752,1916,0,6096,170221,160457,a,6957
6958,2388,166204,2462,0,2484,173538,166204,c,6958
6959,168961,1685,990,0,1457,173093,168961,a,6959
6960,166983,1676,1548,0,2817,173024,166983,a,6960
6961,1615,166686,2003,0,3793,174097,166686,c,6961
6962,165174,1521,2405,0,5033,174133,165174,a,6962
6963,734,425,2155,0,170799,174113,170799,t,6963
6964,1094,622,1290,0,172243,175249,172243,t,6964
6965,465,860,1533,0,174793,177651,174793,t,6965
6966,773,706,173554,0,3614,178647,173554,g,6966
6967,1204,918,1505,0,170527,174154,170527,t,6967
6968,1811,168730,1601,0,1554,173696,168730,c,6968
6969,163441,1650,1624,0,3934,170649,163441,a,6969
6970,1311,163480,6107,0,1907,172805,163480,c,6970
6971,166209,2934,1609,0,2962,173714,166209,a,6971
6972,1630,166757,3168,0,3310,174865,166757,c,6972
6973,2144,168042,3422,0,1901,175509,168042,c,6973
6974,168481,1777,3225,0,2301,175784,168481,a,6974
6975,166023,1672,3682,0,4912,176289,166023,a,6975
6976,1006,2112,1199,0,173610,177927,173610,t,6976
6977,496,453,174728,0,3588,179265,174728,g,6977
6978,899,731,804,0,176965,179399,176965,t,6978
6979,2104,1126,2740,0,173706,179676,173706,t,6979
6980,712,1929,174616,0,2554,179811,174616,g,6980
6981,171649,2628,3899,0,1770,179946,171649,a,6981
6982,999,471,177059,0,1506,180035,177059,g,6982
6983,172710,1660,2372,0,2881,179623,172710,a,6983
6984,3053,171481,2941,0,3533,181008,171481,c,6984
6985,176358,1449,1191,0,9660,188658,176358,a,6985
6986,2999,186326,2544,0,2316,194185,186326,c,6986
6987,189825,1414,1683,0,2014,194936,189825,a,6987
6988,984,518,192317,0,1119,194938,192317,g,6988
6989,1810,186805,2271,0,3094,193980,186805,c,6989
6990,186969,1886,2136,0,4252,195243,186969,a,6990
6991,312,258,2209,0,193480,196259,193480,t,6991
6992,1205,280,987,0,195520,197992,195520,t,6992
6993,1335,728,194689,0,2457,199209,194689,g,6993
6994,193424,1845,1197,0,2724,199190,193424,a,6994
6995,194597,1591,1855,0,1493,199536,194597,a,6995
6996,193534,1655,2926,0,1650,199765,193534,a,6996
6997,191971,1496,1141,0,4970,199578,191971,a,6997
6998,355,1035,764,0,197608,199762,197608,t,6998
6999,452,677,673,0,198268,200070,198268,t,6999
7000,964,196820,999,0,3530,202313,196820,c,7000
7001,1700,196211,1244,0,4524,203679,196211,c,7001
7002,717,357,1825,0,197786,200685,197786,t,7002
7003,1786,195690,1948,0,2009,201433,195690,c,7003
7004,194506,1880,3057,0,2663,202106,194506,a,7004
7005,322,503,199179,0,4126,204130,199179,g,7005
7006,1290,884,1846,0,200584,204604,200584,t,7006
7007,1072,464,200909,0,1991,204436,200909,g,7007
7008,198201,1501,1909,0,2085,203696,198201,a,7008
7009,196987,2341,1470,0,5630,206428,196987,a,7009
7010,1587,203783,1225,0,2285,208880,203783,c,7010
7011,402,434,203625,0,3510,207971,203625,g,7011
7012,1330,860,1482,0,205514,209186,205514,t,7012
7013,541,601,205282,0,3796,210220,205282,g,7013
7014,816,782,634,0,208393,210625,208393,t,7014
7015,1340,207316,1131,0,2215,212002,207316,c,7015
7016,1117,207320,982,0,3371,212790,207320,c,7016
7017,1451,205737,1916,0,3654,212758,205737,c,7017
7018,1031,281,2386,0,208077,211775,208077,t,7018
7019,209328,972,650,0,1274,212224,209328,a,7019
7020,208103,1555,380,0,5541,215579,208103,a,7020
7021,1398,213002,2129,0,1248,217777,213002,c,7021
7022,210984,1335,1076,0,1830,215225,210984,a,7022
7023,442,404,213912,0,1602,216360,213912,g,7023
7024,2143,209762,725,0,4065,216695,209762,c,7024
7025,899,311,761,0,214687,216658,214687,t,7025
7026,209881,1522,1396,0,3770,216569,209881,a,7026
7027,408,355,1723,0,214941,217427,214941,t,7027
7028,1684,1047,1634,0,215144,219509,215144,t,7028
7029,616,922,217785,0,790,220113,217785,g,7029
7030,1280,215354,1524,0,1479,219637,215354,c,7030
7031,2698,213757,1608,0,801,218864,213757,c,7031
7032,211886,1114,1609,0,657,215266,211886,a,7032
7033,208798,3037,1092,0,2809,215736,208798,a,7033
7034,1890,211025,1625,0,2394,216934,211025,c,7034
7035,4368,196688,1800,0,1673,204529,196688,c,7035
7036,198011,757,3586,0,864,203218,198011,a,7036
7037,199495,1368,1523,0,988,203374,199495,a,7037
7038,1219,464,199373,0,4143,205199,199373,g,7038
7039,2564,193115,3031,0,4880,203590,193115,c,7039
7040,3681,195113,2924,0,896,202614,195113,c,7040
7041,197079,1163,2732,0,2504,203478,197079,a,7041
7042,2332,194116,5318,0,2498,204264,194116,c,7042
7043,198310,3357,778,0,1852,204297,198310,a,7043
7044,394,384,201815,0,5671,208264,201815,g,7044
7045,2259,4606,1000,0,205063,212928,205063,t,7045
7046,701,500,212704,0,758,214663,212704,g,7046
7047,1136,604,2827,0,209512,214079,209512,t,7047
7048,4038,558,1997,0,208180,214773,208180,t,7048
7049,211073,1007,2242,0,1072,215394,211073,a,7049
7050,208576,1668,2911,0,2661,215816,208576,a,7050
7051,3942,1151,1384,0,209765,216242,209765,t,7051
7052,1296,1259,211556,0,1151,215262,211556,g,7052
7053,1487,4169,208763,0,4700,219119,208763,g,7053
7054,1266,400,217976,0,519,220161,217976,g,7054
7055,1334,498,494,0,219289,221615,219289,t,7055
7056,1337,217010,3609,0,732,222688,217010,c,7056
7057,678,249,1744,0,219822,222493,219822,t,7057
7058,4510,1042,329,0,217493,223374,217493,t,7058
7059,346,447,222316,0,1737,224846,222316,g,7059
7060,924,284,223087,0,2722,227017,223087,g,7060
7061,932,298,223684,0,940,225854,223684,g,7061
7062,222480,1608,605,0,482,225175,222480,a,7062
7063,221933,1146,648,0,1761,225488,221933,a,7063
7064,222076,2358,303,0,668,225405,222076,a,7064
7065,891,293,223785,0,816,225785,223785,g,7065
7066,2435,583,221455,0,516,224989,221455,g,7066
7067,220094,1400,2496,0,1341,225331,220094,a,7067
7068,1505,368,702,0,224606,227181,224606,t,7068
7069,555,1815,224154,0,1920,228444,224154,g,7069
7070,1670,376,223404,0,3783,229233,223404,g,7070
7071,2874,223357,1597,0,2553,230381,223357,c,7071
7072,1633,224373,3041,0,1252,230299,224373,c,7072
7073,225906,1140,2585,0,420,230051,225906,a,7073
7074,569,252,723,0,228358,229902,228358,t,7074
7075,773,2110,949,0,232429,236261,232429,t,7075
7076,263,491,237161,0,699,238614,237161,g,7076
7077,591,548,1156,0,240740,243035,240740,t,7077
7078,1364,241633,1819,0,350,245166,241633,c,7078
7079,242311,984,1234,0,470,244999,242311,a,7079
7080,242170,1653,654,0,539,245016,242170,a,7080
7081,242024,1924,612,0,501,245061,242024,a,7081
7082,677,283,243625,0,514,245099,243625,g,7082
7083,241755,1951,582,0,4756,249044,241755,a,7083
7084,595,371,986,0,250549,252501,250549,t,7084
7085,981,429,251001,0,506,252917,251001,g,7085
7086,423,238,250984,0,1022,252667,250984,g,7086
7087,250573,1223,236,0,863,252895,250573,a,7087
7088,1332,249900,851,0,3322,255405,249900,c,7088
7089,254421,1446,353,0,554,256774,254421,a,7089
7090,472,204,302,0,261295,262273,261295,t,7090
7091,1100,262572,171,0,686,264529,262572,c,7091
7092,243,164,262537,0,578,263522,262537,g,7092
7093,280,282,262008,0,464,263034,262008,g,7093
7094,259216,2132,469,0,2130,263947,259216,a,7094
7095,275,149,263675,0,408,264507,263675,g,7095
7096,743,368,902,0,262056,264069,262056,t,7096
7097,243,195,303,0,263595,264336,263595,t,7097
7098,1147,262146,152,0,775,264220,262146,c,7098
7099,1162,262023,664,0,398,264247,262023,c,7099
7100,1120,262325,177,0,6343,269965,262325,c,7100
7101,949,271082,272,0,307,272610,271082,c,7101
7102,594,142,611,0,270770,272117,270770,t,7102
7103,290,184,439,0,271583,272496,271583,t,7103
7104,1364,270614,264,0,458,272700,270614,c,7104
7105,411,441,370,0,271600,272822,271600,t,7105
7106,1001,271332,153,0,483,272969,271332,c,7106
7107,267,274,271422,0,391,272354,271422,g,7107
7108,1155,269833,537,0,536,272061,269833,c,7108
7109,1178,269732,563,0,951,272424,269732,c,7109
7110,270629,1363,242,0,312,272546,270629,a,7110
7111,271,123,400,0,270885,271679,270885,t,7111
7112,399,566,183,0,270943,272091,270943,t,7112
7113,267,171,271483,0,617,272538,271483,g,7113
7114,324,253,271661,0,634,272872,271661,g,7114
7115,269187,1864,397,0,869,272317,269187,a,7115
7116,854,264,312,0,273255,274685,273255,t,7116
7117,306,299,274136,0,1802,276543,274136,g,7117
7118,1016,274812,334,0,482,276644,274812,c,7118
7119,585,364,645,0,275004,276598,275004,t,7119
7120,274123,1101,318,0,1993,277535,274123,a,7120
7121,1104,276358,505,0,1059,279026,276358,c,7121
7122,372,310,494,0,282747,283923,282747,t,7122
7123,1165,285015,280,0,618,287078,285015,c,7123
7124,284132,1426,1062,0,674,287294,284132,a,7124
7125,1140,283808,905,0,568,286421,283808,c,7125
7126,283366,1066,348,0,883,285663,283366,a,7126
7127,283671,1255,631,0,1822,287379,283671,a,7127
7128,864,314,286385,0,345,287908,286385,g,7128
7129,2129,506,557,0,279575,282767,279575,t,7129
7130,1396,279261,1847,0,342,282846,279261,c,7130
7131,279762,958,492,0,346,281558,279762,a,7131
7132,276840,958,703,0,1609,280110,276840,a,7132
7133,1247,276519,1284,0,775,279825,276519,c,7133
7134,3072,261326,1858,0,826,267082,261326,c,7134
7135,1230,259446,4605,0,3247,268528,259446,c,7135
7136,2708,262948,2197,0,2851,270704,262948,c,7136
7137,265704,1182,1942,0,1859,270687,265704,a,7137
7138,1917,320,2257,0,267624,272118,267624,t,7138
7139,268069,1203,1734,0,383,271389,268069,a,7139
7140,266551,1221,2770,0,5177,275719,266551,a,7140
7141,1844,272648,2577,0,650,277719,272648,c,7141
7142,624,1768,948,0,274428,277768,274428,t,7142
7143,1242,274428,2351,0,387,278408,274428,c,7143
7144,697,539,1945,0,275434,278615,275434,t,7144
7145,1667,274355,988,0,1386,278396,274355,c,7145
7146,272431,1735,1952,0,1472,277590,272431,a,7146
7147,1543,271148,3264,0,2055,278010,271148,c,7147
7148,267360,1230,1242,0,1648,271480,267360,a,7148
7149,1029,678,268794,0,2012,272513,268794,g,7149
7150,2922,265220,2139,0,1741,272022,265220,c,7150
7151,268130,1573,1231,0,494,271428,268130,a,7151
7152,1011,648,268220,0,1920,271799,268220,g,7152
7153,3732,265341,826,0,567,270466,265341,c,7153
7154,942,1119,2230,0,265037,269328,265037,t,7154
7155,1323,265489,593,0,1112,268517,265489,c,7155
7156,765,339,3461,0,263293,267858,263293,t,7156
7157,501,714,1310,0,264954,267479,264954,t,7157
7158,1006,1056,2156,0,261503,265721,261503,t,7158
7159,748,285,1628,0,263875,266536,263875,t,7159
7160,1561,262121,1173,0,1354,266209,262121,c,7160
7161,1390,277,2635,0,259781,264083,259781,t,7161
7162,1132,501,2051,0,257371,261055,257371,t,7162
7163,254726,1474,950,0,744,257894,254726,a,7163
7164,1721,250827,2165,0,1957,256670,250827,c,7164
7165,2433,2274,1799,0,243419,249925,243419,t,7165
7166,446,471,246513,0,1155,248585,246513,g,7166
7167,1911,429,244794,0,690,247824,244794,g,7167
7168,4163,813,1052,0,240891,246919,240891,t,7168
7169,244371,1475,599,0,1566,248011,244371,a,7169
7170,858,462,245304,0,1132,247756,245304,g,7170
7171,4611,240085,1367,0,703,246766,240085,c,7171
7172,239533,1105,3344,0,2263,246245,239533,a,7172
7173,1259,242972,1452,0,1009,246692,242972,c,7173
7174,240970,1230,3418,0,621,246239,240970,a,7174
7175,579,353,1181,0,243906,246019,243906,t,7175
7176,1163,2270,669,0,242198,246300,242198,t,7176
7177,242015,832,2513,0,1291,246651,242015,a,7177
7178,588,556,1890,0,245854,248888,245854,t,7178
7179,1079,479,247278,0,1348,250184,247278,g,7179
7180,1362,244869,1722,0,2837,250790,244869,c,7180
7181,2998,244954,895,0,737,249584,244954,c,7181
7182,242802,1357,2186,0,426,246771,242802,a,7182
7183,940,203,1479,0,245092,247714,245092,t,7183
7184,1047,243697,1965,0,845,247554,243697,c,7184
7185,242641,1988,1695,0,631,246955,242641,a,7185
7186,1175,274,834,0,241056,243339,241056,t,7186
7187,240217,1882,254,0,429,242782,240217,a,7187
7188,982,547,240444,0,1019,242992,240444,g,7188
7189,2211,871,236331,0,2785,242198,236331,g,7189
7190,1453,691,238648,0,2729,243521,238648,g,7190
7191,3068,238683,939,0,7076,249766,238683,c,7191
7192,2454,245801,1083,0,2313,251651,245801,c,7192
7193,247633,2137,532,0,2672,252974,247633,a,7193
7194,957,306,251548,0,636,253447,251548,g,7194
7195,1931,354,247928,0,495,250708,247928,g,7195
7196,239980,1882,1077,0,8241,251180,239980,a,7196
7197,2134,248789,2418,0,1011,254352,248789,c,7197
7198,1852,630,1465,0,250089,254036,250089,t,7198
7199,1071,249399,1336,0,2834,254640,249399,c,7199
7200,1403,248680,2276,0,841,253200,248680,c,7200
7201,246497,997,1353,0,2601,251448,246497,a,7201
7202,247338,2370,1043,0,2123,252874,247338,a,7202
7203,974,455,252352,0,905,254686,252352,g,7203
7204,1227,247939,3508,0,909,253583,247939,c,7204
7205,248474,1070,1862,0,504,251910,248474,a,7205
7206,248100,1469,744,0,1360,251673,248100,a,7206
7207,246373,1796,2955,0,544,251668,246373,a,7207
7208,248002,1747,1076,0,668,251493,248002,a,7208
7209,1274,645,248387,0,1292,251598,248387,g,7209
7210,1724,246436,1244,0,793,250197,246436,c,7210
7211,244308,824,3448,0,487,249067,244308,a,7211
7212,243916,843,387,0,2995,248141,243916,a,7212
7213,2322,240784,843,0,1722,245671,240784,c,7213
7214,2451,228700,2165,0,2586,235902,228700,c,7214
7215,225545,1725,1338,0,2253,230861,225545,a,7215
7216,980,1469,226849,0,2145,231443,226849,g,7216
7217,1981,744,222710,0,2090,227525,222710,g,7217
7218,1976,557,220198,0,897,223628,220198,g,7218
7219,217275,1412,1395,0,1867,221949,217275,a,7219
7220,220342,1541,489,0,1167,223539,220342,a,7220
7221,1238,517,219927,0,5807,227489,219927,g,7221
7222,5572,220482,3179,0,992,230225,220482,c,7222
7223,1052,608,3543,0,227228,232431,227228,t,7223
7224,2634,228705,704,0,3966,236009,228705,c,7224
7225,227641,2216,6288,0,2509,238654,227641,a,7225
7226,598,451,237685,0,941,239675,237685,g,7226
7227,232148,1475,3138,0,2591,239352,232148,a,7227
7228,235131,1254,2269,0,727,239381,235131,a,7228
7229,232013,1383,3692,0,1884,238972,232013,a,7229
7230,236461,1508,542,0,545,239056,236461,a,7230
7231,687,388,237176,0,929,239180,237176,g,7231
7232,231367,3632,1838,0,1960,238797,231367,a,7232
7233,630,363,236978,0,787,238758,236978,g,7233
7234,2356,229241,808,0,4506,236911,229241,c,7234
7235,232079,2590,1210,0,943,236822,232079,a,7235
7236,1505,450,233473,0,1208,236636,233473,g,7236
7237,2000,230010,1212,0,2972,236194,230010,c,7237
7238,230919,1417,3037,0,944,236317,230919,a,7238
7239,1996,792,230290,0,3950,237028,230290,g,7239
7240,3179,230373,412,0,2693,236657,230373,c,7240
7241,1357,732,233306,0,974,236369,233306,g,7241
7242,2226,703,229003,0,1688,233620,229003,g,7242
7243,3168,637,226718,0,1473,231996,226718,g,7243
7244,3292,219843,2642,0,1090,226867,219843,c,7244
7245,213366,1858,2651,0,708,218583,213366,a,7245
7246,2004,618,2393,0,211564,216579,211564,t,7246
7247,3074,210907,1549,0,591,216121,210907,c,7247
7248,208303,1158,2712,0,2959,215132,208303,a,7248
7249,582,2457,1234,0,221228,225501,221228,t,7249
7250,642,439,229605,0,1061,231747,229605,g,7250
7251,225166,881,3542,0,2013,231602,225166,a,7251
7252,229489,921,722,0,396,231528,229489,a,7252
7253,227693,1038,2265,0,327,231323,227693,a,7253
7254,224406,1226,3746,0,373,229751,224406,a,7254
7255,225302,1013,1572,0,2191,230078,225302,a,7255
7256,1738,223578,3480,0,1060,229856,223578,c,7256
7257,3789,216741,1678,0,2467,224675,216741,c,7257
7258,1865,215986,5210,0,1108,224169,215986,c,7258
7259,217517,992,2021,0,2518,223048,217517,a,7259
7260,215390,3188,1888,0,1889,222355,215390,a,7260
7261,2183,214081,4665,0,1142,222071,214081,c,7261
7262,1204,1936,1973,0,215452,220565,215452,t,7262
7263,619,979,218795,0,505,220898,218795,g,7263
7264,2123,690,695,0,217442,220950,217442,t,7264
7265,3775,215402,989,0,804,220970,215402,c,7265
7266,574,330,218855,0,834,220593,218855,g,7266
7267,206616,1853,1891,0,1444,211804,206616,a,7267
7268,1509,2451,4801,0,203545,212306,203545,t,7268
7269,1970,1409,204638,0,1357,209374,204638,g,7269
7270,706,502,206799,0,1248,209255,206799,g,7270
7271,204695,1032,1405,0,1749,208881,204695,a,7271
7272,203413,1338,1755,0,956,207462,203413,a,7272
7273,3043,781,4062,0,199018,206904,199018,t,7273
7274,202296,1216,2169,0,972,206653,202296,a,7274
7275,200218,981,3708,0,12805,217712,200218,a,7275
7276,1749,215450,3824,0,1527,222550,215450,c,7276
7277,217380,1616,1865,0,2033,222894,217380,a,7277
7278,512,393,219627,0,1252,221784,219627,g,7278
7279,2219,1580,2571,0,217213,223583,217213,t,7279
7280,986,388,222029,0,1315,224718,222029,g,7280
7281,218055,1440,1328,0,1730,222553,218055,a,7281
7282,2555,423,1209,0,218737,222924,218737,t,7282
7283,3010,926,1162,0,217404,222502,217404,t,7283
7284,583,603,218713,0,732,220631,218713,g,7284
7285,215429,1134,1769,0,9960,228292,215429,a,7285
7286,1618,226955,1398,0,3253,233224,226955,c,7286
7287,1593,223990,2625,0,949,229157,223990,c,7287
7288,940,351,1022,0,225779,228092,225779,t,7288
7289,224781,1586,915,0,1018,228300,224781,a,7289
7290,1353,386,225175,0,1101,228015,225175,g,7290
7291,220763,1264,1463,0,1667,225157,220763,a,7291
7292,614,425,1203,0,222378,224620,222378,t,7292
7293,1458,216105,2086,0,1533,221182,216105,c,7293
7294,1680,213641,4295,0,1252,220868,213641,c,7294
7295,215751,1068,1469,0,961,219249,215751,a,7295
7296,214034,952,1712,0,874,217572,214034,a,7296
7297,1334,447,4226,0,211468,217475,211468,t,7297
7298,196713,1038,1339,0,2371,201461,196713,a,7298
7299,1264,190470,5035,0,4485,201254,190470,c,7299
7300,1913,196326,1273,0,8180,207692,196326,c,7300
7301,1171,198355,7991,0,2214,209731,198355,c,7301
7302,719,1364,6252,0,199429,207764,199429,t,7302
7303,200061,1922,2564,0,1455,206002,200061,a,7303
7304,5425,608,1418,0,198246,205697,198246,t,7304
7305,631,362,203390,0,1387,205770,203390,g,7305
7306,201590,1200,963,0,1691,205444,201590,a,7306
7307,915,385,5256,0,198993,205549,198993,t,7307
7308,1247,200221,3004,0,6374,210846,200221,c,7308
7309,1679,202491,7290,0,2177,213637,202491,c,7309
7310,206861,1871,2387,0,1820,212939,206861,a,7310
7311,207821,1859,2382,0,1192,213254,207821,a,7311
7312,207556,2260,1448,0,3432,214696,207556,a,7312
7313,652,293,212470,0,1558,214973,212470,g,7313
7314,5858,819,1212,0,206908,214797,206908,t,7314
7315,1660,792,5520,0,207897,215869,207897,t,7315
7316,896,695,2126,0,212571,216288,212571,t,7316
7317,666,288,213994,0,977,215925,213994,g,7317
7318,206800,1183,2727,0,4380,215090,206800,a,7318
7319,211921,1389,864,0,1156,215330,211921,a,7319
7320,207965,1489,4302,0,1613,215369,207965,a,7320
7321,211529,1088,521,0,1901,215039,211529,a,7321
7322,1351,358,208923,0,3921,214553,208923,g,7322
7323,1834,209398,1280,0,1074,213586,209398,c,7323
7324,206806,1731,1333,0,4131,214001,206806,a,7324
7325,507,926,209785,0,1081,212299,209785,g,7325
7326,1810,457,2131,0,204646,209044,204646,t,7326
7327,1182,1795,1197,0,205532,209706,205532,t,7327
7328,889,1876,205546,0,2773,211084,205546,g,7328
7329,1469,532,207048,0,2748,211797,207048,g,7329
7330,1070,681,208841,0,1213,211805,208841,g,7330
7331,204465,1342,912,0,2593,209312,204465,a,7331
7332,2448,204005,1432,0,2478,210363,204005,c,7332
7333,202067,1374,1987,0,1331,206759,202067,a,7333
7334,201105,2032,1734,0,2718,207589,201105,a,7334
7335,657,610,205774,0,1507,208548,205774,g,7335
7336,2278,846,1602,0,203117,207843,203117,t,7336
7337,203416,961,2370,0,1196,207943,203416,a,7337
7338,202795,1236,1790,0,2365,208186,202795,a,7338
7339,2186,432,1145,0,204969,208732,204969,t,7339
7340,745,958,205347,0,1721,208771,205347,g,7340
7341,2611,202262,711,0,2604,208188,202262,c,7341
7342,791,810,1748,0,204915,208264,204915,t,7342
7343,1481,203327,601,0,2443,207852,203327,c,7343
7344,1331,202719,1817,0,1849,207716,202719,c,7344
7345,546,519,1770,0,204242,207077,204242,t,7345
7346,203197,1068,1088,0,2022,207375,203197,a,7346
7347,696,349,205654,0,1270,207969,205654,g,7347
7348,1589,464,608,0,205104,207765,205104,t,7348
7349,1125,202786,1419,0,2932,208262,202786,c,7349
7350,1792,202712,1419,0,2438,208361,202712,c,7350
7351,601,287,618,0,206977,208483,206977,t,7351
7352,1212,202684,1090,0,3639,208625,202684,c,7352
7353,639,329,1805,0,205904,208677,205904,t,7353
7354,587,479,206751,0,2011,209828,206751,g,7354
7355,1188,206427,1273,0,1414,210302,206427,c,7355
7356,737,286,208173,0,1112,210308,208173,g,7356
7357,754,433,1036,0,207859,210082,207859,t,7357
7358,692,567,207559,0,1154,209972,207559,g,7358
7359,206554,920,786,0,5477,213737,206554,a,7359
7360,1268,212350,759,0,1766,216143,212350,c,7360
7361,784,424,580,0,215130,216918,215130,t,7361
7362,1483,213497,1550,0,1152,217682,213497,c,7362
7363,213956,1436,1627,0,789,217808,213956,a,7363
7364,214459,1900,575,0,1061,217995,214459,a,7364
7365,370,287,216536,0,1043,218236,216536,g,7365
7366,1863,782,610,0,214696,217951,214696,t,7366
7367,295,251,215842,0,1931,218319,215842,g,7367
7368,976,884,277,0,216887,219024,216887,t,7368
7369,1390,314,321,0,217526,219551,217526,t,7369
7370,381,309,217528,0,1083,219301,217528,g,7370
7371,214018,1520,697,0,1209,217444,214018,a,7371
7372,742,747,806,0,215087,217382,215087,t,7372
7373,421,618,214979,0,916,216934,214979,g,7373
7374,212853,1394,749,0,1548,216544,212853,a,7374
7375,905,376,479,0,215834,217594,215834,t,7375
7376,626,784,215236,0,991,217637,215236,g,7376
7377,213775,1268,727,0,4074,219844,213775,a,7377
7378,1181,376,218954,0,1256,221767,218954,g,7378
7379,901,620,216699,0,1432,219652,216699,g,7379
7380,216070,1386,581,0,1869,219906,216070,a,7380
7381,1632,214403,1104,0,2847,219986,214403,c,7381
7382,996,1389,1181,0,215278,218844,215278,t,7382
7383,214565,798,1831,0,2792,219986,214565,a,7383
7384,1108,216558,1876,0,1336,220878,216558,c,7384
7385,217306,1169,1352,0,1183,221010,217306,a,7385
7386,1679,246,667,0,219343,221935,219343,t,7386
7387,669,917,219774,0,1164,222524,219774,g,7387
7388,2145,568,218551,0,2071,223335,218551,g,7388
7389,635,477,221408,0,2339,224859,221408,g,7389
7390,1996,220539,767,0,1420,224722,220539,c,7390
7391,972,781,1325,0,221217,224295,221217,t,7391
7392,1286,217848,498,0,2554,222186,217848,c,7392
7393,667,1029,746,0,219615,222057,219615,t,7393
7394,305,387,219695,0,751,221138,219695,g,7394
7395,1077,760,570,0,218574,220981,218574,t,7395
7396,417,824,218923,0,901,221065,218923,g,7396
7397,1536,1327,1209,0,212583,216655,212583,t,7397
7398,1495,350,213397,0,680,215922,213397,g,7398
7399,209726,1542,946,0,983,213197,209726,a,7399
7400,1326,395,209834,0,1298,212853,209834,g,7400
7401,1707,1004,188889,0,7693,199293,188889,g,7401
7402,1929,197084,1685,0,7344,208042,197084,c,7402
7403,1063,249,209488,0,644,211444,209488,g,7403
7404,1785,713,2101,0,206492,211091,206492,t,7404
7405,3046,725,2042,0,204468,210281,204468,t,7405
7406,205878,1137,1561,0,1209,209785,205878,a,7406
7407,205352,1328,2065,0,1229,209974,205352,a,7407
7408,1048,204822,3493,0,2794,212157,204822,c,7408
7409,1709,207649,2066,0,1393,212817,207649,c,7409
7410,814,251,2716,0,208890,212671,208890,t,7410
7411,570,739,800,0,211517,213626,211517,t,7411
7412,210691,2025,775,0,614,214105,210691,a,7412
7413,712,435,212189,0,670,214006,212189,g,7413
7414,2040,204582,2713,0,1883,211218,204582,c,7414
7415,585,133,206791,0,771,208280,206791,g,7415
7416,202287,1176,632,0,2271,206366,202287,a,7416
7417,3706,199127,559,0,3467,206859,199127,c,7417
7418,3822,199219,1198,0,673,204912,199219,c,7418
7419,778,243,201801,0,1975,204797,201801,g,7419
7420,2700,408,200492,0,1227,204827,200492,g,7420
7421,2193,262,193470,0,5570,201495,193470,g,7421
7422,1835,196406,1077,0,2659,201977,196406,c,7422
7423,2677,195052,3479,0,889,202097,195052,c,7423
7424,804,247,1895,0,198027,200973,198027,t,7424
7425,197904,1104,627,0,742,200377,197904,a,7425
7426,805,234,2051,0,198681,201771,198681,t,7426
7427,1961,198318,1403,0,2318,204000,198318,c,7427
7428,857,299,2102,0,203792,207050,203792,t,7428
7429,1581,204209,1675,0,1485,208950,204209,c,7429
7430,2397,204282,1713,0,965,209357,204282,c,7430
7431,205141,1412,1290,0,1356,209199,205141,a,7431
7432,850,204754,2312,0,1401,209317,204754,c,7432
7433,205255,1730,1542,0,456,208983,205255,a,7433
7434,384,170,2072,0,206249,208875,206249,t,7434
7435,562,1029,1285,0,207482,210358,207482,t,7435
7436,351,253,209463,0,1404,211471,209463,g,7436
7437,1226,521,493,0,209842,212082,209842,t,7437
7438,717,808,210260,0,734,212519,210260,g,7438
7439,426,275,210367,0,1185,212253,210367,g,7439
7440,612,487,209212,0,682,210993,209212,g,7440
7441,207694,1300,401,0,4577,213972,207694,a,7441
7442,212911,1922,473,0,2585,217891,212911,a,7442
7443,1345,334,216458,0,813,218950,216458,g,7443
7444,539,233,217203,0,758,218733,217203,g,7444
7445,215220,1423,1021,0,867,218531,215220,a,7445
7446,215147,1524,1303,0,1009,218983,215147,a,7446
7447,216007,1256,1115,0,666,219044,216007,a,7447
7448,777,220,527,0,217278,218802,217278,t,7448
7449,1970,212633,828,0,2445,217876,212633,c,7449
7450,1677,209889,1276,0,1456,214298,209889,c,7450
7451,208725,1366,605,0,3162,213858,208725,a,7451
7452,488,356,211559,0,1674,214077,211559,g,7452
7453,2372,827,200279,0,1210,204688,200279,g,7453
7454,1010,394,195469,0,1167,198040,195469,g,7454
7455,194255,2046,503,0,1370,198174,194255,a,7455
7456,679,2208,194158,0,4155,201200,194158,g,7456
7457,1029,957,199946,0,1136,203068,199946,g,7457
7458,1540,1038,1793,0,198468,202839,198468,t,7458
7459,787,1344,4840,0,196112,203083,196112,t,7459
7460,585,763,1706,0,201377,204431,201377,t,7460
7461,4595,1031,998,0,199586,206210,199586,t,7461
7462,737,333,204552,0,1012,206634,204552,g,7462
7463,544,356,201466,0,1065,203431,201466,g,7463
7464,192495,1487,2087,0,1115,197184,192495,a,7464
7465,192521,882,1849,0,3924,199176,192521,a,7465
7466,2236,192032,4653,0,823,199744,192032,c,7466
7467,195660,1140,1076,0,2710,200586,195660,a,7467
7468,1997,193851,4662,0,889,201399,193851,c,7468
7469,1342,890,2980,0,195548,200760,195548,t,7469
7470,195905,1258,2236,0,1129,200528,195905,a,7470
7471,2396,193379,2613,0,1792,200180,193379,c,7471
7472,1578,195127,2397,0,1083,200185,195127,c,7472
7473,196413,1069,2238,0,443,200163,196413,a,7473
7474,477,267,2035,0,197496,200275,197496,t,7474
7475,756,1534,479,0,197704,200473,197704,t,7475
7476,538,333,196865,0,858,198594,196865,g,7476
7477,1049,193664,960,0,2470,198143,193664,c,7477
7478,195412,1542,745,0,363,198062,195412,a,7478
7479,239,117,197317,0,696,198369,197317,g,7479
7480,912,657,1014,0,196293,198876,196293,t,7480
7481,217,700,197991,0,439,199347,197991,g,7481
7482,818,277,446,0,198684,200225,198684,t,7482
7483,1981,197725,470,0,868,201044,197725,c,7483
7484,198094,910,1814,0,601,201419,198094,a,7484
7485,198333,1186,1144,0,610,201273,198333,a,7485
7486,782,240,541,0,200085,201648,200085,t,7486
7487,624,475,200445,0,470,202014,200445,g,7487
7488,559,251,200021,0,1555,202386,200021,g,7488
7489,1079,199883,722,0,941,202625,199883,c,7489
7490,647,588,649,0,200726,202610,200726,t,7490
7491,201289,457,496,0,394,202636,201289,a,7491
7492,200606,1114,311,0,1760,203791,200606,a,7492
7493,983,202313,727,0,1261,205284,202313,c,7493
7494,202928,1138,506,0,290,204862,202928,a,7494
7495,347,145,495,0,203583,204570,203583,t,7495
7496,367,474,465,0,204201,205507,204201,t,7496
7497,276,304,424,0,204753,205757,204753,t,7497
7498,315,254,636,0,204375,205580,204375,t,7498
7499,360,217,422,0,203345,204344,203345,t,7499
7500,198656,934,649,0,745,200984,198656,a,7500
7501,290,116,197382,0,467,198255,197382,g,7501
7502,195750,1261,357,0,1292,198660,195750,a,7502
7503,369,256,197976,0,678,199279,197976,g,7503
7504,732,312,197426,0,438,198908,197426,g,7504
7505,646,195,197480,0,724,199045,197480,g,7505
7506,196494,1554,362,0,2166,200576,196494,a,7506
7507,504,214,199673,0,317,200708,199673,g,7507
7508,1038,1599,714,0,195902,199253,195902,t,7508
7509,398,209,1622,0,196304,198533,196304,t,7509
7510,196109,697,548,0,8210,205564,196109,a,7510
7511,781,206665,387,0,387,208220,206665,c,7511
7512,504,164,1526,0,205623,207817,205623,t,7512
7513,270,381,298,0,206736,207685,206736,t,7513
7514,423,371,206446,0,729,207969,206446,g,7514
7515,523,256,204968,0,1760,207507,204968,g,7515
7516,2083,204192,374,0,995,207644,204192,c,7516
7517,1316,204603,1305,0,319,207543,204603,c,7517
7518,846,161,205422,0,344,206773,205422,g,7518
7519,467,194,204075,0,962,205698,204075,g,7519
7520,202828,1773,516,0,2805,207922,202828,a,7520
7521,1129,254,206580,0,6272,214235,206580,g,7521
7522,1449,211995,695,0,1638,215777,211995,c,7522
7523,460,351,1166,0,214870,216847,214870,t,7523
7524,507,287,215855,0,765,217414,215855,g,7524
7525,749,206,214755,0,1049,216759,214755,g,7525
7526,213251,1537,358,0,4353,219499,213251,a,7526
7527,1221,217473,1754,0,764,221212,217473,c,7527
7528,1611,401,698,0,217637,220347,217637,t,7528
7529,270,181,619,0,223688,224758,223688,t,7529
7530,911,224729,324,0,468,226432,224729,c,7530
7531,240,175,637,0,226345,227397,226345,t,7531
7532,904,225397,634,0,608,227543,225397,c,7532
7533,446,227,1073,0,225440,227186,225440,t,7533
7534,491,138,558,0,225767,226954,225767,t,7534
7535,263,117,1076,0,224896,226352,224896,t,7535
7536,412,98,472,0,225122,226104,225122,t,7536
7537,1158,223599,610,0,260,225627,223599,c,7537
7538,1061,223196,485,0,321,225063,223196,c,7538
7539,221538,496,672,0,207,222913,221538,a,7539
7540,358,124,607,0,221129,222218,221129,t,7540
7541,1015,219951,412,0,308,221686,219951,c,7541
7542,219128,853,853,0,377,221211,219128,a,7542
7543,292,153,344,0,221577,222366,221577,t,7543
7544,229,130,222083,0,553,222995,222083,g,7544
7545,220592,701,276,0,1557,223126,220592,a,7545
7546,222027,838,243,0,411,223519,222027,a,7546
7547,408,120,222300,0,1841,224669,222300,g,7547
7548,222614,900,325,0,1082,224921,222614,a,7548
7549,222530,623,754,0,4687,228594,222530,a,7549
7550,1247,228193,345,0,693,230478,228193,c,7550
7551,226050,890,1033,0,1564,229537,226050,a,7551
7552,996,226759,1503,0,1074,230332,226759,c,7552
7553,227262,918,582,0,446,229208,227262,a,7553
7554,226380,810,701,0,1750,229641,226380,a,7554
7555,1151,226361,889,0,2028,230429,226361,c,7555
7556,2173,223666,1654,0,824,228317,223666,c,7556
7557,226001,755,1252,0,425,228433,226001,a,7557
7558,225681,1458,521,0,1318,228978,225681,a,7558
7559,1838,224726,2279,0,561,229404,224726,c,7559
7560,223620,1454,553,0,2302,227929,223620,a,7560
7561,1418,225927,414,0,1431,229190,225927,c,7561
7562,339,279,227850,0,707,229175,227850,g,7562
7563,223623,2065,551,0,2711,228950,223623,a,7563
7564,786,247,227689,0,641,229363,227689,g,7564
7565,213545,1743,474,0,2851,218613,213545,a,7565
7566,215449,1542,883,0,6041,223915,215449,a,7566
7567,1018,478,219844,0,4829,226169,219844,g,7567
7568,1080,3151,220948,0,4161,229340,220948,g,7568
7569,807,595,227243,0,2025,230670,227243,g,7569
7570,2732,690,224359,0,549,228330,224359,g,7570
7571,224600,1451,1309,0,550,227910,224600,a,7571
7572,223795,1146,981,0,2916,228838,223795,a,7572
7573,2288,221193,4254,0,2132,229867,221193,c,7573
7574,3337,655,2781,0,222880,229653,222880,t,7574
7575,1037,985,226661,0,1333,230016,226661,g,7575
7576,761,617,225654,0,2439,229471,225654,g,7576
7577,2864,221285,2464,0,1751,228364,221285,c,7577
7578,215978,2692,2214,0,1324,222208,215978,a,7578
7579,217641,950,1842,0,2022,222455,217641,a,7579
7580,1608,214173,4686,0,2202,222669,214173,c,7580
7581,214022,1920,2866,0,742,219550,214022,a,7581
7582,664,524,3356,0,215563,220107,215563,t,7582
7583,213321,4025,878,0,2173,220397,213321,a,7583
7584,1519,367,217084,0,1115,220085,217084,g,7584
7585,1926,390,214147,0,2382,218845,214147,g,7585
7586,213612,1295,1282,0,1171,217360,213612,a,7586
7587,1949,358,213525,0,1015,216847,213525,g,7587
7588,206760,1728,1114,0,1204,210806,206760,a,7588
7589,1523,336,207314,0,1335,210508,207314,g,7589
7590,201050,4167,679,0,3358,209254,201050,a,7590
7591,2589,201531,3378,0,1502,209000,201531,c,7591
7592,623,973,203263,0,7691,212550,203263,g,7592
7593,2617,207358,1536,0,1063,212574,207358,c,7593
7594,895,691,6591,0,204343,212520,204343,t,7594
7595,1536,1562,596,0,208093,211787,208093,t,7595
7596,1565,489,208337,0,488,210879,208337,g,7596
7597,990,294,201616,0,5052,207952,201616,g,7597
7598,203515,1492,786,0,2100,207893,203515,a,7598
7599,919,397,205828,0,893,208037,205828,g,7599
7600,197320,2496,4479,0,891,205186,197320,a,7600
7601,1082,252,203026,0,877,205237,203026,g,7601
7602,198866,1339,879,0,1121,202205,198866,a,7602
7603,198017,1063,930,0,813,200823,198017,a,7603
7604,197114,1079,1055,0,1826,201074,197114,a,7604
7605,1145,1270,2514,0,200005,204934,200005,t,7605
7606,1286,253,204450,0,2075,208064,204450,g,7606
7607,520,150,204831,0,2858,208359,204831,g,7607
7608,204632,924,1204,0,1369,208129,204632,a,7608
7609,203080,789,3007,0,322,207198,203080,a,7609
7610,203212,898,2012,0,3232,209354,203212,a,7610
7611,206735,937,506,0,4724,212902,206735,a,7611
7612,1111,1801,210112,0,1138,214162,210112,g,7612
7613,2593,207223,344,0,2644,212804,207223,c,7613
7614,1881,208142,2119,0,846,212988,208142,c,7614
7615,506,488,208158,0,1737,210889,208158,g,7615
7616,204433,1766,2977,0,591,209767,204433,a,7616
7617,926,491,2225,0,205512,209154,205512,t,7617
7618,2055,943,1560,0,203319,207877,203319,t,7618
7619,473,288,206500,0,610,207871,206500,g,7619
7620,203523,1019,1286,0,1248,207076,203523,a,7620
7621,202877,1015,997,0,2322,207211,202877,a,7621
7622,2122,202641,1081,0,631,206475,202641,c,7622
7623,2702,368,191301,0,1112,195483,191301,g,7623
7624,1557,188725,3129,0,1722,195133,188725,c,7624
7625,188956,1466,2992,0,230,193644,188956,a,7625
7626,1029,484,1901,0,189705,193119,189705,t,7626
7627,2259,2979,413,0,185152,190803,185152,t,7627
7628,2079,333,185019,0,971,188402,185019,g,7628
7629,726,1163,184301,0,5526,191716,184301,g,7629
7630,1332,432,188933,0,954,191651,188933,g,7630
7631,1602,395,188213,0,444,190654,188213,g,7631
7632,183421,1137,1246,0,633,186437,183421,a,7632
7633,182733,1130,1746,0,553,186162,182733,a,7633
7634,180083,1073,3679,0,868,185703,180083,a,7634
7635,182438,1576,586,0,5856,190456,182438,a,7635
7636,621,818,191867,0,374,193680,191867,g,7636
7637,1811,2346,2226,0,187007,193390,187007,t,7637
7638,430,318,192237,0,211,193196,192237,g,7638
7639,187894,579,1135,0,3271,192879,187894,a,7639
7640,189312,1982,885,0,552,192731,189312,a,7640
7641,1345,526,3616,0,187521,193008,187521,t,7641
7642,1150,600,903,0,189950,192603,189950,t,7642
7643,1303,187575,2457,0,1714,193049,187575,c,7643
7644,1868,188186,1011,0,2490,193555,188186,c,7644
7645,190528,990,897,0,733,193148,190528,a,7645
7646,406,367,191318,0,339,192430,191318,g,7646
7647,174807,732,2118,0,517,178174,174807,a,7647
7648,582,337,2650,0,173998,177567,173998,t,7648
7649,2889,172582,1460,0,304,177235,172582,c,7649
7650,982,170,2192,0,173665,177009,173665,t,7650
7651,173196,1684,1043,0,854,176777,173196,a,7651
7652,1610,170747,2831,0,1036,176224,170747,c,7652
7653,172125,1077,2058,0,687,175947,172125,a,7653
7654,172339,902,2010,0,2244,177495,172339,a,7654
7655,1414,182,176601,0,432,178629,176601,g,7655
7656,175619,1104,1136,0,466,178325,175619,a,7656
7657,176167,736,795,0,440,178138,176167,a,7657
7658,174246,824,2397,0,614,178081,174246,a,7658
7659,175742,1661,256,0,5600,183259,175742,a,7659
7660,315,174,185470,0,365,186324,185470,g,7660
7661,1765,1425,542,0,181878,185610,181878,t,7661
7662,209,651,184525,0,328,185713,184525,g,7662
7663,761,126,180478,0,1927,183292,180478,g,7663
7664,180722,1040,620,0,828,183210,180722,a,7664
7665,180738,689,1378,0,228,183033,180738,a,7665
7666,489,180,354,0,181549,182572,181549,t,7666
7667,1265,180039,988,0,2426,184718,180039,c,7667
7668,1346,181764,775,0,2120,186005,181764,c,7668
7669,184054,1249,655,0,405,186363,184054,a,7669
7670,230,114,186071,0,339,186754,186071,g,7670
7671,1430,126,180455,0,197,182208,180455,g,7671
7672,177025,873,1153,0,1958,181009,177025,a,7672
7673,179262,874,1156,0,1450,182742,179262,a,7673
7674,825,187,181241,0,1197,183450,181241,g,7674
7675,2552,1363,641,0,179166,183722,179166,t,7675
7676,261,859,182378,0,741,184239,182378,g,7676
7677,419,248,181562,0,3598,185827,181562,g,7677
7678,182727,962,2007,0,1377,187073,182727,a,7678
7679,1727,518,771,0,184449,187465,184449,t,7679
7680,187040,600,364,0,740,188744,187040,a,7680
7681,589,113,187621,0,422,188745,187621,g,7681
7682,187026,706,241,0,335,188308,187026,a,7682
7683,184575,271,2078,0,2088,189012,184575,a,7683
7684,1354,187029,287,0,1689,190359,187029,c,7684
7685,1416,183236,2724,0,735,188111,183236,c,7685
7686,1080,459,1102,0,185483,188124,185483,t,7686
7687,425,343,647,0,187271,188686,187271,t,7687
7688,187122,1264,454,0,1915,190755,187122,a,7688
7689,785,264,189414,0,1036,191499,189414,g,7689
7690,1299,185684,2916,0,539,190438,185684,c,7690
7691,186527,733,2674,0,640,190574,186527,a,7691
7692,188802,932,680,0,321,190735,188802,a,7692
7693,188393,1098,807,0,430,190728,188393,a,7693
7694,188791,1069,405,0,547,190812,188791,a,7694
7695,698,199,189371,0,661,190929,189371,g,7695
7696,184453,1296,243,0,663,186655,184453,a,7696
7697,183009,1013,2329,0,763,187114,183009,a,7697
7698,970,330,183941,0,1738,186979,183941,g,7698
7699,1449,273,182934,0,1102,185758,182934,g,7699
7700,1786,178224,1765,0,2286,184061,178224,c,7700
7701,177034,1273,1578,0,455,180340,177034,a,7701
7702,652,175,2108,0,177267,180202,177267,t,7702
7703,1025,2491,1075,0,175764,180355,175764,t,7703
7704,175956,1020,2585,0,1072,180633,175956,a,7704
7705,176322,1186,2323,0,993,180824,176322,a,7705
7706,177666,1186,1122,0,911,180885,177666,a,7706
7707,177882,1294,737,0,506,180419,177882,a,7707
7708,726,169,177775,0,345,179015,177775,g,7708
7709,169623,1480,657,0,4122,175882,169623,a,7709
7710,749,185,174183,0,2041,177158,174183,g,7710
7711,614,460,168286,0,1658,171018,168286,g,7711
7712,165953,969,2440,0,1639,171001,165953,a,7712
7713,2235,357,167542,0,2308,172442,167542,g,7713
7714,167443,1141,1093,0,1391,171068,167443,a,7714
7715,168167,504,2161,0,1132,171964,168167,a,7715
7716,166700,988,1376,0,10498,179562,166700,a,7716
7717,1795,176720,2773,0,4007,185295,176720,c,7717
7718,2396,358,179444,0,1491,183689,179444,g,7718
7719,1434,356,177307,0,648,179745,177307,g,7719
7720,174117,1133,1200,0,2519,178969,174117,a,7720
7721,4311,168368,1620,0,2975,177274,168368,c,7721
7722,2694,155580,5844,0,1198,165316,155580,c,7722
7723,163317,439,1586,0,323,165665,163317,a,7723
7724,766,170,3517,0,163067,167520,163067,t,7724
7725,3701,163461,552,0,919,168633,163461,c,7725
7726,159425,1102,5904,0,3539,169970,159425,a,7726
7727,2010,165747,945,0,1114,169816,165747,c,7727
7728,1094,558,167236,0,507,169395,167236,g,7728
7729,1576,159216,2446,0,5227,168465,159216,c,7729
7730,1839,4934,655,0,160599,168027,160599,t,7730
7731,347,168,167045,0,229,167789,167045,g,7731
7732,1142,1112,1022,0,163698,166974,163698,t,7732
7733,772,164,166324,0,378,167638,166324,g,7733
7734,969,371,695,0,167484,169519,167484,t,7734
7735,6291,163381,435,0,539,170646,163381,c,7735
7736,425,237,169698,0,1368,171728,169698,g,7736
7737,2031,163908,4706,0,1046,171691,163908,c,7737
7738,514,516,170099,0,282,171411,170099,g,7738
7739,168375,1104,543,0,909,170931,168375,a,7739
7740,4371,347,165787,0,643,171148,165787,g,7740
7741,3850,301,165631,0,933,170715,165631,g,7741
7742,1841,163112,4739,0,610,170302,163112,c,7742
7743,4437,1964,936,0,162863,170200,162863,t,7743
7744,2070,163976,3461,0,750,170257,163976,c,7744
7745,165711,1004,945,0,4558,172218,165711,a,7745
7746,892,233,171361,0,853,173339,171361,g,7746
7747,1925,167340,1030,0,3007,173302,167340,c,7747
7748,171503,795,510,0,255,173063,171503,a,7748
7749,168661,620,3149,0,431,172861,168661,a,7749
7750,170696,987,428,0,272,172383,170696,a,7750
7751,168191,685,494,0,3463,172833,168191,a,7751
7752,1709,170019,620,0,574,172922,170019,c,7752
7753,700,309,516,0,171365,172890,171365,t,7753
7754,411,1463,169699,0,392,171965,169699,g,7754
7755,168315,1627,1789,0,825,172556,168315,a,7755
7756,770,138,171119,0,309,172336,171119,g,7756
7757,168239,1086,1601,0,837,171763,168239,a,7757
7758,879,178,1144,0,169762,171963,169762,t,7758
7759,339,559,170638,0,578,172114,170638,g,7759
7760,396,143,170857,0,363,171759,170857,g,7760
7761,940,541,904,0,168342,170727,168342,t,7761
7762,465,530,410,0,170106,171511,170106,t,7762
7763,1172,169335,554,0,1485,172546,169335,c,7763
7764,302,265,171888,0,244,172699,171888,g,7764
7765,682,570,431,0,171102,172785,171102,t,7765
7766,1163,171033,343,0,724,173263,171033,c,7766
7767,295,156,171686,0,449,172586,171686,g,7767
7768,168868,1921,506,0,1445,172740,168868,a,7768
7769,489,222,171459,0,479,172649,171459,g,7769
7770,168698,1688,432,0,1241,172059,168698,a,7770
7771,314,119,171708,0,370,172511,171708,g,7771
7772,168917,1164,384,0,493,170958,168917,a,7772
7773,169008,856,674,0,446,170984,169008,a,7773
7774,169319,822,185,0,421,170747,169319,a,7774
7775,555,174,1174,0,167530,169433,167530,t,7775
7776,166648,984,368,0,275,168275,166648,a,7776
7777,751,186,1108,0,166493,168538,166493,t,7777
7778,406,1248,166365,0,2536,170555,166365,g,7778
7779,1009,176,168513,0,323,170021,168513,g,7779
7780,969,444,1266,0,167326,170005,167326,t,7780
7781,2245,166074,796,0,276,169391,166074,c,7781
7782,165912,1878,746,0,543,169079,165912,a,7782
7783,1140,164238,2776,0,365,168519,164238,c,7783
7784,164685,1255,687,0,1483,168110,164685,a,7784
7785,1249,164741,884,0,1687,168561,164741,c,7785
7786,1505,163581,2306,0,469,167861,163581,c,7786
7787,162235,1625,1053,0,2320,167233,162235,a,7787
7788,521,164,166230,0,300,167215,166230,g,7788
7789,160030,1687,275,0,2785,164777,160030,a,7789
7790,161990,1442,483,0,1672,165587,161990,a,7790
7791,591,780,163543,0,1970,166884,163543,g,7791
7792,615,204,165473,0,558,166850,165473,g,7792
7793,424,205,164962,0,493,166084,164962,g,7793
7794,163585,1509,379,0,376,165849,163585,a,7794
7795,163548,1048,935,0,251,165782,163548,a,7795
7796,162960,1383,474,0,684,165501,162960,a,7796
7797,776,242,163822,0,286,165126,163822,g,7797
7798,3045,814,1971,0,157611,163441,157611,t,7798
7799,162297,1301,738,0,3064,167400,162297,a,7799
7800,461,150,166801,0,2849,170261,166801,g,7800
7801,1487,1109,961,0,166157,169714,166157,t,7801
7802,1808,299,166427,0,752,169286,166427,g,7802
7803,855,160,163845,0,1099,165959,163845,g,7803
7804,162560,978,549,0,1425,165512,162560,a,7804
7805,1935,158778,1742,0,3812,166267,158778,c,7805
7806,2761,159852,1318,0,276,164207,159852,c,7806
7807,618,303,507,0,162218,163646,162218,t,7807
7808,1123,161652,316,0,472,163563,161652,c,7808
7809,278,288,162537,0,921,164024,162537,g,7809
7810,306,116,163130,0,355,163907,163130,g,7810
7811,1464,398,1563,0,158922,162347,158922,t,7811
7812,2058,222,2423,0,156654,161357,156654,t,7812
7813,609,166,159685,0,702,161162,159685,g,7813
7814,1551,156542,1409,0,1797,161299,156542,c,7814
7815,412,1362,159236,0,435,161445,159236,g,7815
7816,1194,446,158813,0,570,161023,158813,g,7816
7817,2561,153111,600,0,948,157220,153111,c,7817
7818,152299,2398,1246,0,285,156228,152299,a,7818
7819,731,153,154590,0,640,156114,154590,g,7819
7820,151743,1706,1166,0,1338,155953,151743,a,7820
7821,1863,238,153045,0,603,155749,153045,g,7821
7822,1204,523,150748,0,1178,153653,150748,g,7822
7823,149709,1671,1305,0,1410,154095,149709,a,7823
7824,2268,422,150808,0,2456,155954,150808,g,7824
7825,923,889,149222,0,1166,152200,149222,g,7825
7826,3677,145643,1517,0,703,151540,145643,c,7826
7827,2563,1238,1917,0,142810,148528,142810,t,7827
7828,765,2325,144573,0,1008,148671,144573,g,7828
7829,2393,237,144321,0,396,147347,144321,g,7829
7830,2476,858,2948,0,135659,141941,135659,t,7830
7831,2895,136627,1665,0,541,141728,136627,c,7831
7832,136386,1753,2691,0,370,141200,136386,a,7832
7833,1370,448,4168,0,134924,140910,134924,t,7833
7834,137598,1634,716,0,681,140629,137598,a,7834
7835,4680,132639,2747,0,347,140413,132639,c,7835
7836,1185,1331,2837,0,131904,137257,131904,t,7836
7837,133060,1816,1571,0,354,136801,133060,a,7837
7838,1200,375,3357,0,131753,136685,131753,t,7838
7839,1102,2970,605,0,132040,136717,132040,t,7839
7840,598,580,134141,0,843,136162,134141,g,7840
7841,1943,2938,1713,0,127327,133921,127327,t,7841
7842,1931,2532,128094,0,1811,134368,128094,g,7842
7843,2293,502,125207,0,1385,129387,125207,g,7843
7844,3275,907,118007,0,2347,124536,118007,g,7844
7845,978,583,122052,0,525,124138,122052,g,7845
7846,3025,469,116661,0,1866,122021,116661,g,7846
7847,116616,1155,1115,0,2693,121579,116616,a,7847
7848,3501,114451,3404,0,333,121689,114451,c,7848
7849,974,432,6916,0,114628,122950,114628,t,7849
7850,119258,1397,3375,0,411,124441,119258,a,7850
7851,119704,1337,3028,0,835,124904,119704,a,7851
7852,121168,2123,1213,0,710,125214,121168,a,7852
7853,795,248,123815,0,354,125212,123815,g,7853
7854,118465,1917,1272,0,1563,123217,118465,a,7854
7855,115121,1500,5699,0,887,123207,115121,a,7855
7856,960,2131,1912,0,118871,123874,118871,t,7856
7857,711,416,121991,0,479,123597,121991,g,7857
7858,1411,549,2530,0,118748,123238,118748,t,7858
7859,118729,1861,846,0,1765,123201,118729,a,7859
7860,117944,1454,2904,0,3034,125336,117944,a,7860
7861,1591,704,122796,0,2015,127106,122796,g,7861
7862,120247,736,2417,0,1818,125218,120247,a,7862
7863,1255,689,122461,0,940,125345,122461,g,7863
7864,118813,1181,953,0,2265,123212,118813,a,7864
7865,118198,1254,2434,0,4707,126593,118198,a,7865
7866,1102,1312,125613,0,353,128380,125613,g,7866
7867,1443,539,3746,0,123146,128874,123146,t,7867
7868,1460,124019,2946,0,1133,129558,124019,c,7868
7869,125313,812,2092,0,753,128970,125313,a,7869
7870,125550,917,1635,0,610,128712,125550,a,7870
7871,124362,1238,1776,0,1139,128515,124362,a,7871
7872,2354,556,124538,0,1612,129060,124538,g,7872
7873,2224,413,122216,0,1344,126197,122216,g,7873
7874,1538,120822,2152,0,1763,126275,120822,c,7874
7875,1954,120968,2270,0,1156,126348,120968,c,7875
7876,743,694,1780,0,124171,127388,124171,t,7876
7877,823,1491,124131,0,948,127393,124131,g,7877
7878,122453,819,2095,0,1272,126639,122453,a,7878
7879,2268,121377,2108,0,1526,127279,121377,c,7879
7880,123621,891,1290,0,808,126610,123621,a,7880
7881,123568,780,1151,0,1198,126697,123568,a,7881
7882,123281,958,1661,0,1239,127139,123281,a,7882
7883,124079,1416,1156,0,1604,128255,124079,a,7883
7884,913,469,126560,0,778,128720,126560,g,7884
7885,557,270,123662,0,966,125455,123662,g,7885
7886,121324,1278,942,0,1850,125394,121324,a,7886
7887,1404,1113,122471,0,760,125748,122471,g,7887
7888,811,235,121606,0,843,123495,121606,g,7888
7889,119289,670,1122,0,2668,123749,119289,a,7889
7890,2660,118203,1891,0,3807,126561,118203,c,7890
7891,1532,122567,1725,0,2634,128458,122567,c,7891
7892,125845,1189,1156,0,931,129121,125845,a,7892
7893,533,365,127830,0,830,129558,127830,g,7893
7894,629,202,127645,0,573,129049,127645,g,7894
7895,123416,686,1504,0,3020,128626,123416,a,7895
7896,2826,123678,1709,0,959,129172,123678,c,7896
7897,124356,1271,2020,0,1437,129084,124356,a,7897
7898,1030,254,1330,0,129252,131866,129252,t,7898
7899,623,352,131271,0,693,132939,131271,g,7899
7900,129030,655,822,0,2743,133250,129030,a,7900
7901,131868,659,716,0,622,133865,131868,a,7901
7902,1506,248,130923,0,514,133191,130923,g,7902
7903,129026,497,896,0,529,130948,129026,a,7903
7904,125585,339,2367,0,3014,131305,125585,a,7904
7905,2718,126355,1020,0,1174,131267,126355,c,7905
7906,2814,121561,1918,0,1944,128237,121561,c,7906
7907,1494,121969,2653,0,900,127016,121969,c,7907
7908,121487,924,1911,0,246,124568,121487,a,7908
7909,1338,360,1935,0,121020,124653,121020,t,7909
7910,1764,119496,1294,0,1698,124252,119496,c,7910
7911,1563,117766,3265,0,1478,124072,117766,c,7911
7912,1534,118422,2479,0,1187,123622,118422,c,7912
7913,2400,118381,1553,0,570,122904,118381,c,7913
7914,119480,942,1738,0,1701,123861,119480,a,7914
7915,1237,438,1701,0,122217,125593,122217,t,7915
7916,1314,533,123741,0,494,126082,123741,g,7916
7917,661,308,1769,0,122933,125671,122933,t,7917
7918,1301,122730,1009,0,430,125470,122730,c,7918
7919,122225,1133,1489,0,515,125362,122225,a,7919
7920,123164,476,858,0,951,125449,123164,a,7920
7921,1188,122577,1313,0,247,125325,122577,c,7921
7922,122387,677,1198,0,220,124482,122387,a,7922
7923,852,272,721,0,122387,124232,122387,t,7923
7924,122193,1006,734,0,269,124202,122193,a,7924
7925,810,181,725,0,122208,123924,122208,t,7925
7926,842,666,121992,0,430,123930,121992,g,7926
7927,638,176,122024,0,2144,124982,122024,g,7927
7928,466,129,124942,0,294,125831,124942,g,7928
7929,1763,710,1084,0,121800,125357,121800,t,7929
7930,660,146,124680,0,525,126011,124680,g,7930
7931,690,153,124390,0,506,125739,124390,g,7931
7932,123993,735,463,0,695,125886,123993,a,7932
7933,124440,799,518,0,296,126053,124440,a,7933
7934,589,223,677,0,125651,127140,125651,t,7934
7935,1061,125322,471,0,497,127351,125322,c,7935
7936,484,304,681,0,126411,127880,126411,t,7936
7937,126524,860,248,0,982,128614,126524,a,7937
7938,332,115,128177,0,974,129598,128177,g,7938
7939,1679,344,616,0,119662,122301,119662,t,7939
7940,120435,414,1084,0,2218,124151,120435,a,7940
7941,815,123176,908,0,1033,125932,123176,c,7941
7942,822,186,125020,0,203,126231,125020,g,7942
7943,480,263,502,0,126238,127483,126238,t,7943
7944,883,126526,381,0,646,128436,126526,c,7944
7945,399,197,1737,0,126617,128950,126617,t,7945
7946,410,255,637,0,127597,128899,127597,t,7946
7947,1299,126207,1073,0,347,128926,126207,c,7947
7948,127356,657,242,0,559,128814,127356,a,7948
7949,126508,751,973,0,345,128577,126508,a,7949
7950,126930,1033,430,0,1549,129942,126930,a,7950
7951,417,210,129912,0,425,130964,129912,g,7951
7952,1345,1059,652,0,126729,129785,126729,t,7952
7953,436,321,128740,0,265,129762,128740,g,7953
7954,436,197,127683,0,1300,129616,127683,g,7954
7955,126876,1456,404,0,1009,129745,126876,a,7955
7956,440,208,128773,0,472,129893,128773,g,7956
7957,1258,238,430,0,127885,129811,127885,t,7957
7958,455,261,647,0,129521,130884,129521,t,7958
7959,408,796,129640,0,774,131618,129640,g,7959
7960,128972,842,412,0,1610,131836,128972,a,7960
7961,1023,130122,484,0,4421,136050,130122,c,7961
7962,329,162,138064,0,373,138928,138064,g,7962
7963,682,197,731,0,137195,138805,137195,t,7963
7964,335,246,754,0,137324,138659,137324,t,7964
7965,279,208,544,0,137625,138656,137625,t,7965
7966,324,104,442,0,139155,140025,139155,t,7966
7967,732,139079,538,0,639,140988,139079,c,7967
7968,306,104,515,0,139797,140722,139797,t,7968
7969,260,139,344,0,139656,140399,139656,t,7969
7970,869,138598,364,0,384,140215,138598,c,7970
7971,138477,672,326,0,687,140162,138477,a,7971
7972,748,138789,292,0,420,140249,138789,c,7972
7973,370,300,340,0,139020,140030,139020,t,7973
7974,663,138709,279,0,406,140057,138709,c,7974
7975,803,138660,368,0,243,140074,138660,c,7975
7976,369,278,138900,0,346,139893,138900,g,7976
7977,664,138445,370,0,649,140128,138445,c,7977
7978,733,138796,241,0,563,140333,138796,c,7978
7979,138065,733,279,0,2585,141662,138065,a,7979
7980,255,182,142201,0,864,143502,142201,g,7980
7981,142409,778,156,0,437,143780,142409,a,7981
7982,142590,820,364,0,293,144067,142590,a,7982
7983,142708,853,304,0,298,144163,142708,a,7983
7984,142706,1029,183,0,754,144672,142706,a,7984
7985,426,208,143892,0,292,144818,143892,g,7985
7986,1387,526,422,0,142965,145300,142965,t,7986
7987,242,197,145727,0,564,146730,145727,g,7987
7988,1145,797,343,0,144498,146783,144498,t,7988
7989,372,138,146560,0,912,147982,146560,g,7989
7990,144793,781,706,0,1690,147970,144793,a,7990
7991,1979,145466,422,0,559,148426,145466,c,7991
7992,145870,634,371,0,1504,148379,145870,a,7992
7993,736,146126,1670,0,701,149233,146126,c,7993
7994,148096,763,296,0,238,149393,148096,a,7994
7995,254,136,1451,0,147918,149759,147918,t,7995
7996,327,1461,262,0,148409,150459,148409,t,7996
7997,230,119,149975,0,352,150676,149975,g,7997
7998,392,185,367,0,149648,150592,149648,t,7998
7999,349,1275,213,0,149726,151563,149726,t,7999
8000,173,143,151107,0,410,151833,151107,g,8000
8001,474,286,275,0,150409,151444,150409,t,8001
8002,105,133,151114,0,285,151637,151114,g,8002
8003,433,252,304,0,150257,151246,150257,t,8003
8004,227,122,150533,0,264,151146,150533,g,8004
8005,148984,624,304,0,455,150367,148984,a,8005
8006,1426,148200,333,0,310,150269,148200,c,8006
8007,147685,627,335,0,231,148878,147685,a,8007
8008,203,93,1375,0,147066,148737,147066,t,8008
8009,147375,776,95,0,1843,150089,147375,a,8009
8010,574,244,149201,0,1680,151699,149201,g,8010
8011,345,406,149517,0,4698,154966,149517,g,8011
8012,773,241,154205,0,535,155754,154205,g,8012
8013,515,201,153468,0,1078,155262,153468,g,8013
8014,152633,1457,220,0,4917,159227,152633,a,8014
8015,591,271,159695,0,385,160942,159695,g,8015
8016,940,266,280,0,161138,162624,161138,t,8016
8017,540,162396,440,0,1673,165049,162396,c,8017
8018,349,395,164400,0,254,165398,164400,g,8018
8019,521,317,425,0,164002,165265,164002,t,8019
8020,982,163296,828,0,1643,166749,163296,c,8020
8021,164213,995,729,0,3254,169191,164213,a,8021
8022,767,166761,979,0,2327,170834,166761,c,8022
8023,1333,167081,801,0,610,169825,167081,c,8023
8024,168064,316,743,0,209,169332,168064,a,8024
8025,166272,703,1355,0,477,168807,166272,a,8025
8026,167030,800,677,0,190,168697,167030,a,8026
8027,666,151,657,0,167356,168830,167356,t,8027
8028,1389,165505,610,0,1073,168577,165505,c,8028
8029,1499,164577,1223,0,1320,168619,164577,c,8029
8030,1577,164349,1995,0,450,168371,164349,c,8030
8031,163570,783,387,0,2015,166755,163570,a,8031
8032,1058,163867,616,0,1082,166623,163867,c,8032
8033,953,256,159973,0,1355,162537,159973,g,8033
8034,804,181,161218,0,467,162670,161218,g,8034
8035,2929,740,387,0,158854,162910,158854,t,8035
8036,160579,1113,998,0,450,163140,160579,a,8036
8037,498,166,162125,0,402,163191,162125,g,8037
8038,160309,608,901,0,2310,164128,160309,a,8038
8039,161435,872,1307,0,2570,166184,161435,a,8039
8040,1291,377,164322,0,1631,167621,164322,g,8040
8041,2719,161171,749,0,2793,167432,161171,c,8041
8042,163865,901,2317,0,1314,168397,163865,a,8042
8043,512,882,165427,0,2664,169485,165427,g,8043
8044,958,427,166921,0,533,168839,166921,g,8044
8045,156564,1094,1381,0,7919,166958,156564,a,8045
8046,3085,162186,2264,0,1897,169432,162186,c,8046
8047,1127,184,167017,0,383,168711,167017,g,8047
8048,164770,793,814,0,1923,168300,164770,a,8048
8049,163048,1119,1939,0,2100,168206,163048,a,8049
8050,1362,161145,3920,0,1392,167819,161145,c,8050
8051,161658,649,2354,0,6090,170751,161658,a,8051
8052,2384,166304,3389,0,926,173003,166304,c,8052
8053,2093,472,2063,0,168816,173444,168816,t,8053
8054,1781,168764,2017,0,1980,174542,168764,c,8054
8055,171122,1319,1759,0,598,174798,171122,a,8055
8056,872,161,172732,0,433,174198,172732,g,8056
8057,168893,2480,588,0,1593,173554,168893,a,8057
8058,433,179,172330,0,396,173338,172330,g,8058
8059,1459,495,678,0,171361,173993,171361,t,8059
8060,1283,169772,2339,0,2415,175809,169772,c,8060
8061,863,171070,2080,0,1853,175866,171070,c,8061
8062,1595,171,1443,0,171857,175066,171857,t,8062
8063,250,173,2524,0,171766,174713,171766,t,8063
8064,172188,1302,228,0,637,174355,172188,a,8064
8065,170903,904,957,0,2396,175160,170903,a,8065
8066,1547,172112,453,0,688,174800,172112,c,8066
8067,1496,184,1346,0,170510,173536,170510,t,8067
8068,298,1123,1636,0,170000,173057,170000,t,8068
8069,170422,1166,1051,0,1764,174403,170422,a,8069
8070,371,245,174122,0,695,175433,174122,g,8070
8071,719,810,573,0,176587,178689,176587,t,8071
8072,266,204,180604,0,514,181588,180604,g,8072
8073,641,208,178273,0,1359,180481,178273,g,8073
8074,177787,1308,471,0,587,180153,177787,a,8074
8075,177358,1138,1111,0,399,180006,177358,a,8075
8076,177510,812,1247,0,372,179941,177510,a,8076
8077,177234,929,549,0,856,179568,177234,a,8077
8078,574,774,985,0,177073,179406,177073,t,8078
8079,495,877,532,0,178150,180054,178150,t,8079
8080,256,830,178474,0,3415,182975,178474,g,8080
8081,284,203,183352,0,538,184377,183352,g,8081
8082,744,357,890,0,183250,185241,183250,t,8082
8083,899,236,478,0,185367,186980,185367,t,8083
8084,281,152,186446,0,705,187584,186446,g,8084
8085,185656,621,655,0,461,187393,185656,a,8085
8086,185309,672,425,0,4934,191340,185309,a,8086
8087,867,192226,463,0,543,194099,192226,c,8087
8088,189840,434,439,0,1970,192683,189840,a,8088
8089,190698,759,986,0,4703,197146,190698,a,8089
8090,1121,196918,1210,0,521,199770,196918,c,8090
8091,198074,391,356,0,218,199039,198074,a,8091
8092,196778,541,514,0,848,198681,196778,a,8092
8093,929,196521,1046,0,732,199228,196521,c,8093
8094,196729,914,580,0,1877,200100,196729,a,8094
8095,732,198409,893,0,872,200906,198409,c,8095
8096,1144,198698,517,0,870,201229,198698,c,8096
8097,1070,198960,1126,0,343,201499,198960,c,8097
8098,199168,666,458,0,1230,201522,199168,a,8098
8099,199074,1454,423,0,470,201421,199074,a,8099
8100,302,118,923,0,200229,201572,200229,t,8100
8101,389,380,259,0,200688,201716,200688,t,8101
8102,358,206,958,0,200328,201850,200328,t,8102
8103,251,247,488,0,201150,202136,201150,t,8103
8104,454,203,201174,0,705,202536,201174,g,8104
8105,820,200035,766,0,661,202282,200035,c,8105
8106,200774,521,567,0,547,202409,200774,a,8106
8107,396,103,702,0,201490,202691,201490,t,8107
8108,201547,544,278,0,550,202919,201547,a,8108
8109,201084,1025,490,0,741,203340,201084,a,8109
8110,201493,1089,310,0,1205,204097,201493,a,8110
8111,436,175,202919,0,2895,206425,202919,g,8111
8112,515,142,205464,0,570,206691,205464,g,8112
8113,1195,352,500,0,206087,208134,206087,t,8113
8114,207,155,320,0,209237,209919,209237,t,8114
8115,969,207851,348,0,716,209884,207851,c,8115
8116,335,180,232,0,208360,209107,208360,t,8116
8117,1314,205240,371,0,561,207486,205240,c,8117
8118,204509,350,593,0,295,205747,204509,a,8118
8119,203202,609,631,0,3349,207791,203202,a,8119
8120,925,206776,514,0,924,209139,206776,c,8120
8121,1495,205142,395,0,1420,208452,205142,c,8121
8122,943,206098,937,0,544,208522,206098,c,8122
8123,205846,927,846,0,495,208114,205846,a,8123
8124,608,128,731,0,206567,208034,206567,t,8124
8125,206121,860,594,0,1181,208756,206121,a,8125
8126,1194,206265,887,0,550,208896,206265,c,8126
8127,206702,557,557,0,383,208199,206702,a,8127
8128,723,336,934,0,205581,207574,205581,t,8128
8129,951,350,205280,0,941,207522,205280,g,8129
8130,1790,202717,768,0,3659,208934,202717,c,8130
8131,1684,204793,1153,0,4333,211963,204793,c,8131
8132,2589,203314,1423,0,778,208104,203314,c,8132
8133,877,773,1312,0,204653,207615,204653,t,8133
8134,1535,202164,1013,0,1226,205938,202164,c,8134
8135,200995,2270,1475,0,1514,206254,200995,a,8135
8136,653,311,204852,0,863,206679,204852,g,8136
8137,1352,701,1133,0,201861,205047,201861,t,8137
8138,1212,201460,1154,0,939,204765,201460,c,8138
8139,201373,809,1713,0,651,204546,201373,a,8139
8140,764,153,1485,0,201877,204279,201877,t,8140
8141,200064,1266,1845,0,3371,206546,200064,a,8141
8142,729,190,206016,0,3573,210508,206016,g,8142
8143,207504,1023,1631,0,888,211046,207504,a,8143
8144,208507,705,1357,0,574,211143,208507,a,8144
8145,209290,903,424,0,654,211271,209290,a,8145
8146,207967,768,2010,0,609,211354,207967,a,8146
8147,208860,845,790,0,567,211062,208860,a,8147
8148,206582,961,1861,0,789,210193,206582,a,8148
8149,593,856,927,0,208623,210999,208623,t,8149
8150,664,419,200333,0,781,202197,200333,g,8150
8151,674,215,198431,0,1857,201177,198431,g,8151
8152,199056,786,489,0,1222,201553,199056,a,8152
8153,199631,693,630,0,1283,202237,199631,a,8153
8154,1187,288,200069,0,978,202522,200069,g,8154
8155,3909,196581,900,0,448,201838,196581,c,8155
8156,195828,679,3349,0,2748,202604,195828,a,8156
8157,1179,199990,479,0,621,202269,199990,c,8157
8158,1325,601,3322,0,191296,196544,191296,t,8158
8159,189907,883,603,0,3105,194498,189907,a,8159
8160,1162,190662,2504,0,752,195080,190662,c,8160
8161,190672,904,1091,0,2085,194752,190672,a,8161
8162,189535,1121,763,0,2442,193861,189535,a,8162
8163,188873,2287,2458,0,2163,195781,188873,a,8163
8164,546,361,194440,0,1524,196871,194440,g,8164
8165,729,293,190235,0,699,191956,190235,g,8165
8166,188062,1124,593,0,573,190352,188062,a,8166
8167,186162,856,2370,0,797,190185,186162,a,8167
8168,186412,793,1347,0,986,189538,186412,a,8168
8169,725,525,2725,0,185698,189673,185698,t,8169
8170,183515,1074,886,0,970,186445,183515,a,8170
8171,348,2607,2337,0,182821,188113,182821,t,8171
8172,545,793,184746,0,1769,187853,184746,g,8172
8173,682,294,183840,0,2039,186855,183840,g,8173
8174,182667,1291,521,0,3165,187644,182667,a,8174
8175,5502,534,180781,0,909,187726,180781,g,8175
8176,1173,371,183114,0,1024,185682,183114,g,8176
8177,182470,1208,483,0,3076,187237,182470,a,8177
8178,924,474,185036,0,3502,189936,185036,g,8178
8179,1672,185023,835,0,1733,189263,185023,c,8179
8180,1094,182212,4567,0,1297,189170,182212,c,8180
8181,844,483,1806,0,184879,188012,184879,t,8181
8182,892,1068,919,0,184957,187836,184957,t,8182
8183,184288,1752,1063,0,1389,188492,184288,a,8183
8184,644,260,187028,0,837,188769,187028,g,8184
8185,1817,559,3008,0,184020,189404,184020,t,8185
8186,903,290,187893,0,708,189794,187893,g,8186
8187,186193,719,636,0,2328,189876,186193,a,8187
8188,2739,289,187046,0,681,190755,187046,g,8188
8189,1014,250,187644,0,1003,189911,187644,g,8189
8190,186742,337,1126,0,2272,190477,186742,a,8190
8191,187658,687,2144,0,1288,191777,187658,a,8191
8192,1378,271,711,0,190304,192664,190304,t,8192
8193,1875,188301,2021,0,850,193047,188301,c,8193
8194,1811,187344,1681,0,2100,192936,187344,c,8194
8195,190708,708,493,0,3729,195638,190708,a,8195
8196,1702,193154,2041,0,689,197586,193154,c,8196
8197,466,471,632,0,196508,198077,196508,t,8197
8198,1361,195564,1188,0,367,198480,195564,c,8198
8199,500,416,778,0,198202,199896,198202,t,8199
8200,1497,197788,683,0,567,200535,197788,c,8200
8201,196759,871,1799,0,5259,204688,196759,a,8201
8202,1048,203793,1556,0,599,206996,203793,c,8202
8203,424,181,205195,0,790,206590,205195,g,8203
8204,203511,765,1382,0,430,206088,203511,a,8204
8205,203604,973,707,0,516,205800,203604,a,8205
8206,203812,726,657,0,766,205961,203812,a,8206
8207,1096,203597,1039,0,301,206033,203597,c,8207
8208,662,212,598,0,204710,206182,204710,t,8208
8209,1201,204454,500,0,2615,208770,204454,c,8209
8210,1938,207112,443,0,401,209894,207112,c,8210
8211,207354,755,435,0,685,209229,207354,a,8211
8212,1163,206419,600,0,340,208522,206419,c,8212
8213,205756,574,416,0,649,207395,205756,a,8213
8214,1028,205176,953,0,1066,208223,205176,c,8214
8215,206117,596,392,0,258,207363,206117,a,8215
8216,583,119,325,0,206660,207687,206660,t,8216
8217,625,544,205450,0,616,207235,205450,g,8217
8218,204242,904,589,0,781,206516,204242,a,8218
8219,639,166,205745,0,290,206840,205745,g,8219
8220,201248,1382,376,0,440,203446,201248,a,8220
8221,671,474,585,0,202199,203929,202199,t,8221
8222,642,298,200877,0,342,202159,200877,g,8222
8223,1391,476,620,0,199275,201762,199275,t,8223
8224,199765,928,743,0,1466,202902,199765,a,8224
8225,1147,199582,1176,0,4747,206652,199582,c,8225
8226,1661,911,534,0,202008,205114,202008,t,8226
8227,893,905,202168,0,1310,205276,202168,g,8227
8228,721,371,202938,0,1438,205468,202938,g,8228
8229,1440,136,202621,0,397,204594,202621,g,8229
8230,1955,515,1274,0,201043,204787,201043,t,8230
8231,203448,1135,548,0,499,205630,203448,a,8231
8232,830,124,1681,0,203579,206214,203579,t,8232
8233,1510,203201,1279,0,1726,207716,203201,c,8233
8234,2190,203601,1958,0,2029,209778,203601,c,8234
8235,208491,859,721,0,429,210500,208491,a,8235
8236,206312,899,2027,0,379,209617,206312,a,8236
8237,2218,447,519,0,207387,210571,207387,t,8237
8238,1051,429,207097,0,635,209212,207097,g,8238
8239,1205,205435,989,0,1699,209328,205435,c,8239
8240,2585,200546,2695,0,470,206296,200546,c,8240
8241,1012,1538,1300,0,201725,205575,201725,t,8241
8242,1588,201642,563,0,3973,207766,201642,c,8242
8243,2715,200029,1956,0,1346,206046,200029,c,8243
8244,1163,1018,199815,0,2437,204433,199815,g,8244
8245,5747,369,185319,0,890,192325,185319,g,8245
8246,849,273,186668,0,542,188332,186668,g,8246
8247,183975,675,893,0,348,185891,183975,a,8247
8248,177447,302,3131,0,5194,186074,177447,a,8248
8249,2017,180872,1653,0,362,184904,180872,c,8249
8250,179321,762,3866,0,214,184163,179321,a,8250
8251,811,249,8057,0,174573,183690,174573,t,8251
8252,177116,4660,185,0,932,182893,177116,a,8252
8253,857,347,181331,0,601,183136,181331,g,8253
8254,1532,5511,407,0,174306,181756,174306,t,8254
8255,451,489,180220,0,350,181510,180220,g,8255
8256,1341,494,679,0,180432,182946,180432,t,8256
8257,4560,176625,1218,0,1578,183981,176625,c,8257
8258,175855,1142,6217,0,247,183461,175855,a,8258
8259,3269,244,1252,0,177973,182738,177973,t,8259
8260,1348,172179,5034,0,4588,183149,172179,c,8260
8261,178863,546,2317,0,3948,185674,178863,a,8261
8262,1259,506,183575,0,944,186284,183575,g,8262
8263,2499,523,5455,0,178033,186510,178033,t,8263
8264,541,142,185545,0,407,186635,185545,g,8264
8265,179999,853,1292,0,2995,185139,179999,a,8265
8266,181022,564,1814,0,5386,188786,181022,a,8266
8267,3696,181125,3959,0,1238,190018,181125,c,8267
8268,183296,540,4223,0,1413,189472,183296,a,8268
8269,2443,417,875,0,185281,189016,185281,t,8269
8270,444,1957,185982,0,953,189336,185982,g,8270
8271,183999,984,2294,0,2508,189785,183999,a,8271
8272,498,484,2729,0,185793,189504,185793,t,8272
8273,1279,1764,2647,0,183561,189251,183561,t,8273
8274,577,157,1309,0,190572,192615,190572,t,8274
8275,1734,190069,1050,0,644,193497,190069,c,8275
8276,189205,598,1554,0,1925,193282,189205,a,8276
8277,188830,2229,1262,0,778,193099,188830,a,8277
8278,722,365,191221,0,651,192959,191221,g,8278
8279,1264,356,189604,0,420,191644,189604,g,8279
8280,187097,1054,1297,0,2187,191635,187097,a,8280
8281,472,396,1319,0,189977,192164,189977,t,8281
8282,286,193,191384,0,300,192163,191384,g,8282
8283,495,314,415,0,190549,191773,190549,t,8283
8284,1263,587,307,0,189515,191672,189515,t,8284
8285,229,110,190955,0,184,191478,190955,g,8285
8286,188805,1036,375,0,250,190466,188805,a,8286
8287,333,315,446,0,189144,190238,189144,t,8287
8288,809,188630,225,0,2800,192464,188630,c,8288
8289,191334,346,286,0,543,192509,191334,a,8289
8290,190107,839,166,0,3234,194346,190107,a,8290
8291,717,193574,680,0,471,195442,193574,c,8291
8292,193960,514,432,0,499,195405,193960,a,8292
8293,252,70,194407,0,659,195388,194407,g,8293
8294,193817,998,313,0,899,196027,193817,a,8294
8295,272,85,659,0,195093,196109,195093,t,8295
8296,190,178,138,0,196454,196960,196454,t,8296
8297,715,195940,200,0,197,197052,195940,c,8297
8298,195678,445,640,0,929,197692,195678,a,8298
8299,594,196305,420,0,409,197728,196305,c,8299
8300,196503,443,378,0,464,197788,196503,a,8300
8301,196107,757,321,0,768,197953,196107,a,8301
8302,489,111,169,0,197587,198356,197587,t,8302
8303,269,147,197900,0,298,198614,197900,g,8303
8304,197159,853,394,0,633,199039,197159,a,8304
8305,419,137,198225,0,346,199127,198225,g,8305
8306,197369,744,168,0,1680,199961,197369,a,8306
8307,802,198830,458,0,349,200439,198830,c,8307
8308,198826,582,395,0,1653,201456,198826,a,8308
8309,803,200126,526,0,2271,203726,200126,c,8309
8310,202987,657,252,0,321,204217,202987,a,8310
8311,202669,733,375,0,1309,205086,202669,a,8311
8312,766,167,203620,0,699,205252,203620,g,8312
8313,202917,608,121,0,1160,204806,202917,a,8313
8314,203038,642,814,0,386,204880,203038,a,8314
8315,203002,905,189,0,2417,206513,203002,a,8315
8316,424,130,206072,0,844,207470,206072,g,8316
8317,2089,200522,129,0,1664,204404,200522,c,8317
8318,1856,199292,1885,0,230,203263,199292,c,8318
8319,199504,497,916,0,1785,202702,199504,a,8319
8320,750,198538,294,0,667,200249,198538,c,8320
8321,621,156,3437,0,193240,197454,193240,t,8321
8322,296,215,3486,0,193055,197052,193055,t,8322
8323,195381,527,211,0,659,196778,195381,a,8323
8324,4120,191723,324,0,362,196529,191723,c,8324
8325,399,142,194419,0,238,195198,194419,g,8325
8326,190497,662,822,0,2737,194718,190497,a,8326
8327,643,182,194039,0,471,195335,194039,g,8327
8328,2274,187781,401,0,1119,191575,187781,c,8328
8329,3455,184883,2732,0,439,191509,184883,c,8329
8330,188696,809,566,0,1731,191802,188696,a,8330
8331,523,1529,187952,0,622,190626,187952,g,8331
8332,183401,1364,1759,0,2762,189286,183401,a,8332
8333,541,305,1216,0,188449,190511,188449,t,8333
8334,357,148,189534,0,853,190892,189534,g,8334
8335,2622,330,275,0,188039,191266,188039,t,8335
8336,190311,623,197,0,871,192002,190311,a,8336
8337,725,205,190832,0,404,192166,190832,g,8337
8338,188123,832,1014,0,1433,191402,188123,a,8338
8339,1026,184935,2006,0,3943,191910,184935,c,8339
8340,2665,187342,1328,0,449,191784,187342,c,8340
8341,863,383,601,0,190757,192604,190757,t,8341
8342,1073,190485,238,0,839,192635,190485,c,8342
8343,268,129,191159,0,341,191897,191159,g,8343
8344,669,219,189995,0,835,191718,189995,g,8344
8345,185463,622,640,0,3012,189737,185463,a,8345
8346,186647,949,1634,0,555,189785,186647,a,8346
8347,731,260,187649,0,1242,189882,187649,g,8347
8348,1275,185862,1204,0,2170,190511,185862,c,8348
8349,456,1018,188998,0,343,190815,188998,g,8349
8350,1169,509,187591,0,497,189766,187591,g,8350
8351,185304,990,735,0,309,187338,185304,a,8351
8352,183942,982,949,0,803,186676,183942,a,8352
8353,2354,182197,850,0,2003,187404,182197,c,8353
8354,1887,183178,1089,0,1921,188075,183178,c,8354
8355,1650,185190,835,0,1561,189236,185190,c,8355
8356,419,299,188472,0,968,190158,188472,g,8356
8357,1159,186060,1961,0,797,189977,186060,c,8357
8358,186361,1239,467,0,575,188642,186361,a,8358
8359,186754,771,761,0,352,188638,186754,a,8359
8360,847,185301,1803,0,495,188446,185301,c,8360
8361,184391,946,1122,0,362,186821,184391,a,8361
8362,436,248,822,0,186323,187829,186323,t,8362
8363,1124,186396,152,0,488,188160,186396,c,8363
8364,336,193,186618,0,358,187505,186618,g,8364
8365,514,324,185039,0,489,186366,185039,g,8365
8366,181234,1551,619,0,1482,184886,181234,a,8366
8367,182394,1203,805,0,226,184628,182394,a,8367
8368,524,185,1892,0,181626,184227,181626,t,8368
8369,735,676,1578,0,181123,184112,181123,t,8369
8370,391,313,182955,0,361,184020,182955,g,8370
8371,181620,971,809,0,374,183774,181620,a,8371
8372,181693,892,644,0,245,183474,181693,a,8372
8373,180868,1309,338,0,1267,183782,180868,a,8373
8374,546,174,182609,0,566,183895,182609,g,8374
8375,2708,807,717,0,178970,183202,178970,t,8375
8376,566,221,182149,0,559,183495,182149,g,8376
8377,181510,983,392,0,564,183449,181510,a,8377
8378,707,142,181309,0,279,182437,181309,g,8378
8379,166080,767,425,0,610,167882,166080,a,8379
8380,689,253,3610,0,163541,168093,163541,t,8380
8381,165571,1386,436,0,777,168170,165571,a,8381
8382,851,163614,747,0,5547,170759,163614,c,8382
8383,1287,168600,1646,0,348,171881,168600,c,8383
8384,166946,612,3248,0,240,171046,166946,a,8384
8385,166863,995,2125,0,193,170176,166863,a,8385
8386,167049,745,886,0,2771,171451,167049,a,8386
8387,1672,166974,2694,0,1104,172444,166974,c,8387
8388,2866,162880,1637,0,320,167703,162880,c,8388
8389,823,382,2434,0,163599,167238,163599,t,8389
8390,163496,2758,785,0,384,167423,163496,a,8390
8391,1302,322,164537,0,565,166726,164537,g,8391
8392,158135,1136,949,0,1552,161772,158135,a,8392
8393,1264,156660,2049,0,485,160458,156660,c,8393
8394,152663,958,2419,0,200,156240,152663,a,8394
8395,961,208,1774,0,152301,155244,152301,t,8395
8396,150636,1483,1834,0,469,154422,150636,a,8396
8397,150394,973,2046,0,757,154170,150394,a,8397
8398,1612,1284,972,0,150403,154271,150403,t,8398
8399,4286,143072,815,0,561,148734,143072,c,8399
8400,540,577,145342,0,1220,147679,145342,g,8400
8401,1706,608,136727,0,1799,140840,136727,g,8401
8402,1830,299,135278,0,977,138384,135278,g,8402
8403,129756,1472,1008,0,2674,134910,129756,a,8403
8404,131248,1291,2037,0,1393,135969,131248,a,8404
8405,129227,1705,4554,0,786,136272,129227,a,8405
8406,132404,1189,1802,0,1258,136653,132404,a,8406
8407,476,266,135753,0,273,136768,135753,g,8407
8408,128927,2862,664,0,3601,136054,128927,a,8408
8409,128825,744,5820,0,271,135660,128825,a,8409
8410,569,237,2786,0,131984,135576,131984,t,8410
8411,130712,2218,2467,0,2573,137970,130712,a,8411
8412,1530,237,137008,0,2899,141674,137008,g,8412
8413,138003,1196,1983,0,1609,142791,138003,a,8413
8414,137240,596,3132,0,1566,142534,137240,a,8414
8415,138298,1798,590,0,1690,142376,138298,a,8415
8416,136813,897,3143,0,1899,142752,136813,a,8416
8417,139075,1199,1833,0,1864,143971,139075,a,8417
8418,138000,554,4732,0,684,143970,138000,a,8418
8419,722,215,1888,0,140998,143823,140998,t,8419
8420,137654,682,1599,0,857,140792,137654,a,8420
8421,135346,379,3619,0,1062,140406,135346,a,8421
8422,137717,673,1481,0,266,140137,137717,a,8422
8423,134730,472,1463,0,3057,139722,134730,a,8423
8424,2346,135019,1129,0,331,138825,135019,c,8424
8425,129597,616,781,0,2175,133169,129597,a,8425
8426,130116,1418,648,0,471,132653,130116,a,8426
8427,1734,367,129490,0,572,132163,129490,g,8427
8428,123682,834,1055,0,865,126436,123682,a,8428
8429,980,336,123424,0,1384,126124,123424,g,8429
8430,2345,120763,1106,0,924,125138,120763,c,8430
8431,118650,567,3588,0,2102,124907,118650,a,8431
8432,787,1776,654,0,123841,127058,123841,t,8432
8433,1016,450,126328,0,1438,129232,126328,g,8433
8434,125399,696,2502,0,649,129246,125399,a,8434
8435,126975,723,598,0,445,128741,126975,a,8435
8436,126882,512,649,0,2654,130697,126882,a,8436
8437,1522,126465,3607,0,911,132505,126465,c,8437
8438,130007,508,762,0,475,131752,130007,a,8438
8439,558,305,2993,0,128775,132631,128775,t,8439
8440,1350,129624,633,0,1908,133515,129624,c,8440
8441,128474,688,3181,0,2215,134558,128474,a,8441
8442,1162,693,756,0,132280,134891,132280,t,8442
8443,1827,1055,132098,0,738,135718,132098,g,8443
8444,822,172,133841,0,577,135412,133841,g,8444
8445,3263,128271,774,0,1303,133611,128271,c,8445
8446,129426,902,1427,0,2567,134322,129426,a,8446
8447,1821,130786,1287,0,1128,135022,130786,c,8447
8448,1424,378,1131,0,131420,134353,131420,t,8448
8449,130974,1256,1554,0,345,134129,130974,a,8449
8450,1246,402,1851,0,130744,134243,130744,t,8450
8451,833,343,132577,0,975,134728,132577,g,8451
8452,131884,485,920,0,3146,136435,131884,a,8452
8453,2102,133086,1259,0,2038,138485,133086,c,8453
8454,2007,133012,1425,0,490,136934,133012,c,8454
8455,133657,540,794,0,1025,136016,133657,a,8455
8456,134487,693,511,0,538,136229,134487,a,8456
8457,1744,420,133270,0,718,136152,133270,g,8457
8458,128540,598,598,0,558,130294,128540,a,8458
8459,1418,125477,2337,0,2210,131442,125477,c,8459
8460,2720,125236,1251,0,761,129968,125236,c,8460
8461,125679,544,1421,0,4723,132367,125679,a,8461
8462,1725,129914,554,0,1257,133450,129914,c,8462
8463,1926,126510,2085,0,699,131220,126510,c,8463
8464,1128,126430,1991,0,1478,131027,126430,c,8464
8465,126499,534,1497,0,771,129301,126499,a,8465
8466,1335,131,1285,0,127452,130203,127452,t,8466
8467,127927,876,968,0,2860,132631,127927,a,8467
8468,1461,129833,2133,0,1558,134985,129833,c,8468
8469,133380,626,1543,0,186,135735,133380,a,8469
8470,133061,773,1722,0,462,136018,133061,a,8470
8471,134351,807,740,0,264,136162,134351,a,8471
8472,133156,621,1543,0,3441,138761,133156,a,8472
8473,2610,137177,221,0,2392,142400,137177,c,8473
8474,635,278,142044,0,502,143459,142044,g,8474
8475,2420,632,445,0,140136,143633,140136,t,8475
8476,705,840,141793,0,1323,144661,141793,g,8476
8477,1028,352,141613,0,2227,145220,141613,g,8477
8478,891,261,143680,0,2059,146891,143680,g,8478
8479,1515,144163,1023,0,812,147513,144163,c,8479
8480,1284,323,492,0,145652,147751,145652,t,8480
8481,923,485,785,0,145764,147957,145764,t,8481
8482,146480,458,416,0,728,148082,146480,a,8482
8483,1426,145288,747,0,928,148389,145288,c,8483
8484,1184,145862,906,0,364,148316,145862,c,8484
8485,146077,749,590,0,482,147898,146077,a,8485
8486,561,521,782,0,146769,148633,146769,t,8486
8487,646,329,147628,0,965,149568,147628,g,8487
8488,431,242,148530,0,1926,151129,148530,g,8488
8489,1246,149063,391,0,793,151493,149063,c,8489
8490,149407,1066,482,0,258,151213,149407,a,8490
8491,574,222,149699,0,554,151049,149699,g,8491
8492,1242,149047,315,0,677,151281,149047,c,8492
8493,466,459,291,0,150194,151410,150194,t,8493
8494,149595,1039,475,0,331,151440,149595,a,8494
8495,335,150,453,0,150510,151448,150510,t,8495
8496,385,242,150545,0,531,151703,150545,g,8496
8497,150137,804,308,0,1356,152605,150137,a,8497
8498,152172,766,236,0,713,153887,152172,a,8498
8499,152815,594,447,0,581,154437,152815,a,8499
8500,1415,152513,461,0,726,155115,152513,c,8500
8501,153568,856,472,0,1164,156060,153568,a,8501
8502,155208,820,381,0,1470,157879,155208,a,8502
8503,156901,1031,276,0,616,158824,156901,a,8503
8504,157178,883,281,0,1197,159539,157178,a,8504
8505,1439,157517,397,0,4036,163389,157517,c,8505
8506,159660,897,253,0,1065,161875,159660,a,8506
8507,159143,703,2038,0,1324,163208,159143,a,8507
8508,162283,779,187,0,2022,165271,162283,a,8508
8509,1555,162125,413,0,2092,166185,162125,c,8509
8510,1067,2814,269,0,157818,161968,157818,t,8510
8511,923,259,160778,0,554,162514,160778,g,8511
8512,680,181,161183,0,847,162891,161183,g,8512
8513,160432,1109,239,0,412,162192,160432,a,8513
8514,4629,752,316,0,158325,164022,158325,t,8514
8515,1558,160334,2461,0,433,164786,160334,c,8515
8516,162889,688,473,0,5461,169511,162889,a,8516
8517,875,387,170768,0,1963,173993,170768,g,8517
8518,1239,172812,317,0,628,174996,172812,c,8518
8519,170516,998,3123,0,268,174905,170516,a,8519
8520,770,203,363,0,173450,174786,173450,t,8520
8521,1032,173575,430,0,459,175496,173575,c,8521
8522,171160,1093,3033,0,416,175702,171160,a,8522
8523,630,237,445,0,174959,176271,174959,t,8523
8524,863,172490,2793,0,601,176747,172490,c,8524
8525,1004,172918,383,0,2588,176893,172918,c,8525
8526,174377,1096,589,0,402,176464,174377,a,8526
8527,486,220,2176,0,173632,176514,173632,t,8527
8528,395,493,175623,0,742,177253,175623,g,8528
8529,401,211,175515,0,917,177044,175515,g,8529
8530,3145,897,830,0,172286,177158,172286,t,8530
8531,1482,265,175107,0,1029,177883,175107,g,8531
8532,176458,670,193,0,722,178043,176458,a,8532
8533,174813,735,1157,0,1998,178703,174813,a,8533
8534,1549,176004,718,0,1777,180048,176004,c,8534
8535,1010,263,176787,0,861,178921,176787,g,8535
8536,619,576,176039,0,1865,179099,176039,g,8536
8537,176443,1000,811,0,2572,180826,176443,a,8537
8538,1364,348,179165,0,1109,181986,179165,g,8538
8539,2074,709,483,0,178272,181538,178272,t,8539
8540,618,537,180183,0,3327,184665,180183,g,8540
8541,1156,520,183613,0,465,185754,183613,g,8541
8542,1541,634,853,0,183286,186314,183286,t,8542
8543,1881,183892,418,0,718,186909,183892,c,8543
8544,184428,991,1037,0,410,186866,184428,a,8544
8545,826,449,185126,0,296,186697,185126,g,8545
8546,184601,1020,380,0,1608,187609,184601,a,8546
8547,1356,185118,1288,0,933,188695,185118,c,8547
8548,613,492,420,0,187700,189225,187700,t,8548
8549,576,364,187899,0,601,189440,187899,g,8549
8550,1020,186975,517,0,1037,189549,186975,c,8550
8551,923,425,337,0,188371,190056,188371,t,8551
8552,411,229,188968,0,499,190107,188968,g,8552
8553,187128,763,719,0,2103,190713,187128,a,8553
8554,1145,188735,876,0,1077,191833,188735,c,8554
8555,190105,646,252,0,411,191414,190105,a,8555
8556,189956,778,317,0,303,191354,189956,a,8556
8557,189798,871,435,0,165,191269,189798,a,8557
8558,189385,899,613,0,681,191578,189385,a,8558
8559,1517,189342,409,0,2133,193401,189342,c,8559
8560,1311,191026,606,0,290,193233,191026,c,8560
8561,575,389,475,0,191924,193363,191924,t,8561
8562,701,954,388,0,192420,194463,192420,t,8562
8563,695,592,192221,0,1105,194613,192221,g,8563
8564,941,310,190317,0,775,192343,190317,g,8564
8565,1047,341,189670,0,464,191522,189670,g,8565
8566,189647,1159,299,0,980,192085,189647,a,8566
8567,1416,189778,589,0,3683,195466,189778,c,8567
8568,1003,867,194535,0,418,196823,194535,g,8568
8569,1042,519,971,0,195159,197691,195159,t,8569
8570,1172,196354,348,0,1232,199106,196354,c,8570
8571,591,443,198134,0,340,199508,198134,g,8571
8572,741,395,705,0,197582,199423,197582,t,8572
8573,1380,196704,663,0,1570,200317,196704,c,8573
8574,1544,197201,876,0,1006,200627,197201,c,8574
8575,1409,197693,669,0,1035,200806,197693,c,8575
8576,1052,198134,842,0,655,200683,198134,c,8576
8577,197901,1320,712,0,939,200872,197901,a,8577
8578,760,244,679,0,199627,201310,199627,t,8578
8579,539,358,200070,0,856,201823,200070,g,8579
8580,315,151,201128,0,531,202125,201128,g,8580
8581,2007,888,1519,0,197742,202156,197742,t,8581
8582,1052,315,200161,0,589,202117,200161,g,8582
8583,198626,1306,563,0,1997,202492,198626,a,8583
8584,1792,200164,836,0,366,203158,200164,c,8584
8585,199244,1347,308,0,1004,201903,199244,a,8585
8586,1772,198936,674,0,724,202106,198936,c,8586
8587,199085,1213,388,0,341,201027,199085,a,8587
8588,817,266,199109,0,537,200729,199109,g,8588
8589,197629,1779,345,0,964,200717,197629,a,8589
8590,914,541,756,0,199058,201269,199058,t,8590
8591,593,1182,197695,0,745,200215,197695,g,8591
8592,521,179,197986,0,2089,200775,197986,g,8592
8593,1626,197647,1157,0,815,201245,197647,c,8593
8594,195513,1549,711,0,492,198265,195513,a,8594
8595,195233,1323,895,0,699,198150,195233,a,8595
8596,974,462,930,0,196117,198483,196117,t,8596
8597,1046,585,195598,0,565,197794,195598,g,8597
8598,194391,1044,840,0,1485,197760,194391,a,8598
8599,2741,193304,1097,0,1391,198533,193304,c,8599
8600,191344,1912,1601,0,834,195691,191344,a,8600
8601,1011,225,193685,0,365,195286,193685,g,8601
8602,189344,1626,746,0,10206,201922,189344,a,8602
8603,3279,199456,2078,0,1133,205946,199456,c,8603
8604,199416,2249,1537,0,1145,204347,199416,a,8604
8605,3435,198747,1533,0,652,204367,198747,c,8605
8606,1322,801,201439,0,517,204079,201439,g,8606
8607,198850,2888,797,0,3403,205938,198850,a,8607
8608,2132,201100,3002,0,632,206866,201100,c,8608
8609,1517,1607,1571,0,200356,205051,200356,t,8609
8610,1817,201490,878,0,1129,205314,201490,c,8610
8611,1457,200115,3056,0,1072,205700,200115,c,8611
8612,199097,2163,1398,0,2238,204896,199097,a,8612
8613,671,267,2673,0,200177,203788,200177,t,8613
8614,611,692,1135,0,201295,203733,201295,t,8614
8615,2578,686,744,0,201285,205293,201285,t,8615
8616,957,482,203216,0,670,205325,203216,g,8616
8617,1026,410,202449,0,420,204305,202449,g,8617
8618,198304,1808,2711,0,1594,204417,198304,a,8618
8619,3497,199136,1297,0,686,204616,199136,c,8619
8620,197899,1407,1080,0,247,200633,197899,a,8620
8621,196705,1022,2158,0,1146,201031,196705,a,8621
8622,3175,194667,2919,0,560,201321,194667,c,8622
8623,198548,1524,707,0,959,201738,198548,a,8623
8624,839,407,199629,0,2327,203202,199629,g,8624
8625,4430,194755,564,0,1889,201638,194755,c,8625
8626,821,545,199298,0,917,201581,199298,g,8626
8627,2056,194177,464,0,2213,198910,194177,c,8627
8628,1667,277,194353,0,301,196598,194353,g,8628
8629,2286,735,2478,0,189786,195285,189786,t,8629
8630,2476,2264,2647,0,187816,195203,187816,t,8630
8631,735,913,2311,0,191026,194985,191026,t,8631
8632,633,1114,4443,0,188333,194523,188333,t,8632
8633,337,403,2254,0,190472,193466,190472,t,8633
8634,189791,1428,937,0,588,192744,189791,a,8634
8635,187070,1195,4038,0,253,192556,187070,a,8635
8636,186373,1330,4432,0,3723,195858,186373,a,8636
8637,701,187,195419,0,1074,197381,195419,g,8637
8638,194146,1421,822,0,316,196705,194146,a,8638
8639,194267,1332,847,0,464,196910,194267,a,8639
8640,194395,1178,642,0,242,196457,194395,a,8640
8641,190685,1108,3718,0,493,196004,190685,a,8641
8642,192790,1489,395,0,1108,195782,192790,a,8642
8643,821,244,192691,0,430,194186,192691,g,8643
8644,2936,1174,1100,0,188120,193330,188120,t,8644
8645,550,296,191984,0,644,193474,191984,g,8645
8646,1198,279,187874,0,2822,192173,187874,g,8646
8647,188538,1232,511,0,1336,191617,188538,a,8647
8648,2101,186530,2227,0,553,191411,186530,c,8648
8649,186364,1536,892,0,20122,208914,186364,a,8649
8650,1468,211567,1346,0,2334,216715,211567,c,8650
8651,1072,815,214517,0,758,217162,214517,g,8651
8652,212997,1242,1200,0,1462,216901,212997,a,8652
8653,1869,662,212835,0,740,216106,212835,g,8653
8654,202450,1182,1556,0,456,205644,202450,a,8654
8655,199863,888,2352,0,2564,205667,199863,a,8655
8656,1910,202054,653,0,1180,205797,202054,c,8656
8657,1465,199030,2737,0,7344,210576,199030,c,8657
8658,1328,207625,2634,0,748,212335,207625,c,8658
8659,208913,1089,1358,0,501,211861,208913,a,8659
8660,208910,1186,478,0,1020,211594,208910,a,8660
8661,2018,347,208526,0,407,211298,208526,g,8661
8662,204760,1088,343,0,1048,207239,204760,a,8662
8663,203493,821,2125,0,2027,208466,203493,a,8663
8664,1354,204673,1333,0,2273,209633,204673,c,8664
8665,1489,204793,2972,0,805,210059,204793,c,8665
8666,524,289,207712,0,2051,210576,207712,g,8666
8667,204868,2760,1554,0,619,209801,204868,a,8667
8668,205171,1538,1974,0,729,209412,205171,a,8668
8669,205237,1352,526,0,1731,208846,205237,a,8669
8670,1010,277,206811,0,438,208536,206811,g,8670
8671,202630,1433,713,0,1344,206120,202630,a,8671
8672,201198,1935,2311,0,1132,206576,201198,a,8672
8673,1075,949,202528,0,1997,206549,202528,g,8673
8674,2317,478,192097,0,3187,198079,192097,g,8674
8675,3201,190201,3238,0,1410,198050,190201,c,8675
8676,190254,1293,1141,0,2228,194916,190254,a,8676
8677,2255,185877,5066,0,3342,196540,185877,c,8677
8678,191213,1023,2008,0,1697,195941,191213,a,8678
8679,192652,678,1453,0,1517,196300,192652,a,8679
8680,192463,1201,2539,0,789,196992,192463,a,8680
8681,1453,251,195041,0,2028,198773,195041,g,8681
8682,194526,918,3047,0,1298,199789,194526,a,8682
8683,196029,834,2748,0,264,199875,196029,a,8683
8684,195709,2194,885,0,1235,200023,195709,a,8684
8685,4699,192306,2367,0,420,199792,192306,c,8685
8686,978,217,3973,0,193897,199065,193897,t,8686
8687,195776,1992,701,0,707,199176,195776,a,8687
8688,192430,727,5648,0,3636,202441,192430,a,8688
8689,699,407,1128,0,202639,204873,202639,t,8689
8690,351,184,204366,0,383,205284,204366,g,8690
8691,199219,604,814,0,4343,204980,199219,a,8691
8692,203503,756,498,0,462,205219,203503,a,8692
8693,200311,331,4203,0,605,205450,200311,a,8693
8694,203166,651,1018,0,211,205046,203166,a,8694
8695,1756,237,1171,0,201192,204356,201192,t,8695
8696,2962,197298,1359,0,259,201878,197298,c,8696
8697,195187,793,763,0,5234,201977,195187,a,8697
8698,1526,199013,1261,0,2839,204639,199013,c,8698
8699,1232,399,196937,0,821,199389,196937,g,8699
8700,1016,310,195475,0,560,197361,195475,g,8700
8701,5554,186508,960,0,2089,195111,186508,c,8701
8702,190611,866,2059,0,363,193899,190611,a,8702
8703,962,338,191402,0,487,193189,191402,g,8703
8704,189418,1322,594,0,1450,192784,189418,a,8704
8705,1574,718,189348,0,809,192449,189348,g,8705
8706,2673,4603,1675,0,181470,190421,181470,t,8706
8707,1148,706,187803,0,432,190089,187803,g,8707
8708,762,321,184736,0,3644,189463,184736,g,8708
8709,2063,184580,562,0,715,187920,184580,c,8709
8710,1909,1225,3022,0,180104,186260,180104,t,8710
8711,2710,378,1432,0,180418,184938,180418,t,8711
8712,824,978,2113,0,180895,184810,180895,t,8712
8713,631,1065,182432,0,1226,185354,182432,g,8713
8714,580,242,183187,0,1523,185532,183187,g,8714
8715,181336,1228,1682,0,257,184503,181336,a,8715
8716,181728,819,1282,0,335,184164,181728,a,8716
8717,180548,706,1352,0,468,183074,180548,a,8717
8718,1398,258,180847,0,272,182775,180847,g,8718
8719,179365,996,667,0,174,181202,179365,a,8719
8720,176884,882,1925,0,1728,181419,176884,a,8720
8721,3455,175877,1407,0,479,181218,175877,c,8721
8722,1501,473,1606,0,168112,171692,168112,t,8722
8723,168596,2559,380,0,941,172476,168596,a,8723
8724,1203,841,169814,0,767,172625,169814,g,8724
8725,1612,351,165336,0,2278,169577,165336,g,8725
8726,899,202,166911,0,946,168958,166911,g,8726
8727,164253,1429,593,0,2574,168849,164253,a,8727
8728,165793,1246,1001,0,3758,171798,165793,a,8728
8729,2160,393,170215,0,697,173465,170215,g,8729
8730,168895,938,2707,0,1049,173589,168895,a,8730
8731,169809,712,2198,0,1306,174025,169809,a,8731
8732,170637,1380,1663,0,1875,175555,170637,a,8732
8733,172172,622,1757,0,2120,176671,172172,a,8733
8734,173238,1349,1510,0,1001,177098,173238,a,8734
8735,1793,423,173461,0,1080,176757,173461,g,8735
8736,171182,1049,729,0,1222,174182,171182,a,8736
8737,2351,167662,3407,0,1604,175024,167662,c,8737
8738,170933,817,1346,0,3082,176178,170933,a,8738
8739,1909,171195,899,0,4431,178434,171195,c,8739
8740,1772,175216,1102,0,322,178412,175216,c,8740
8741,849,439,709,0,176141,178138,176141,t,8741
8742,175006,2534,316,0,298,178154,175006,a,8742
8743,709,226,176592,0,303,177830,176592,g,8743
8744,651,171,176128,0,359,177309,176128,g,8744
8745,172673,1027,922,0,1375,175997,172673,a,8745
8746,1569,445,1628,0,172987,176629,172987,t,8746
8747,459,177,175658,0,242,176536,175658,g,8747
8748,1440,435,1378,0,173106,176359,173106,t,8748
8749,397,769,174612,0,501,176279,174612,g,8749
8750,1584,172918,962,0,312,175776,172918,c,8750
8751,172066,1229,682,0,1037,175014,172066,a,8751
8752,1747,171192,1090,0,343,174372,171192,c,8752
8753,725,418,996,0,171530,173669,171530,t,8753
8754,171425,835,332,0,619,173211,171425,a,8754
8755,647,344,171591,0,515,173097,171591,g,8755
8756,169257,926,1038,0,4082,175303,169257,a,8756
8757,669,198,175729,0,469,177065,175729,g,8757
8758,166843,700,284,0,1143,168970,166843,a,8758
8759,168936,495,631,0,648,170710,168936,a,8759
8760,1031,211,168470,0,510,170222,168470,g,8760
8761,164626,780,498,0,650,166554,164626,a,8761
8762,161509,846,2152,0,817,165324,161509,a,8762
8763,2095,752,1192,0,160356,164395,160356,t,8763
8764,696,319,784,0,164437,166236,164437,t,8764
8765,1506,163367,1163,0,487,166523,163367,c,8765
8766,161260,802,3451,0,1565,167078,161260,a,8766
8767,1991,161320,3479,0,1023,167813,161320,c,8767
8768,162909,714,878,0,1066,165567,162909,a,8768
8769,163398,1030,856,0,1524,166808,163398,a,8769
8770,712,327,165765,0,860,167664,165765,g,8770
8771,164625,1097,619,0,878,167219,164625,a,8771
8772,162940,694,3303,0,569,167506,162940,a,8772
8773,162922,3340,628,0,693,167583,162922,a,8773
8774,1115,432,165340,0,2999,169886,165340,g,8774
8775,1104,233,167605,0,3370,172312,167605,g,8775
8776,4833,2144,1161,0,165683,173821,165683,t,8776
8777,690,207,172715,0,473,174085,172715,g,8777
8778,165838,640,1710,0,3508,171696,165838,a,8778
8779,1464,213,170036,0,1907,173620,170036,g,8779
8780,168993,1000,464,0,2303,172760,168993,a,8780
8781,170858,1010,791,0,1140,173799,170858,a,8781
8782,2795,312,169762,0,1071,173940,169762,g,8782
8783,2063,167098,3851,0,395,173407,167098,c,8783
8784,170950,560,961,0,567,173038,170950,a,8784
8785,167582,1126,3415,0,436,172559,167582,a,8785
8786,1465,376,1379,0,169290,172510,169290,t,8786
8787,1409,196,169001,0,368,170974,169001,g,8787
8788,1651,164397,1297,0,3156,170501,164397,c,8788
8789,168158,1063,773,0,256,170250,168158,a,8789
8790,651,143,168427,0,760,169981,168427,g,8790
8791,2495,163124,498,0,2532,168649,163124,c,8791
8792,1518,163151,1892,0,896,167457,163151,c,8792
8793,790,954,1263,0,162828,165835,162828,t,8793
8794,1062,2762,709,0,161098,165631,161098,t,8794
8795,1112,788,162440,0,697,165037,162440,g,8795
8796,2311,455,159195,0,1512,163473,159195,g,8796
8797,1916,331,157702,0,1970,161919,157702,g,8797
8798,2360,1197,148260,0,4493,156310,148260,g,8798
8799,2070,183,148418,0,764,151435,148418,g,8799
8800,3235,142038,2518,0,1785,149576,142038,c,8800
8801,3941,142380,1583,0,807,148711,142380,c,8801
8802,144698,926,1800,0,411,147835,144698,a,8802
8803,885,425,3597,0,140744,145651,140744,t,8803
8804,143054,1162,736,0,185,145137,143054,a,8804
8805,1026,299,3078,0,140353,144756,140353,t,8805
8806,660,1885,1107,0,141954,145606,141954,t,8806
8807,1687,141187,2207,0,733,145814,141187,c,8807
8808,140794,1241,943,0,2309,145287,140794,a,8808
8809,1129,142396,1475,0,784,145784,142396,c,8809
8810,1612,307,1022,0,140521,143462,140521,t,8810
8811,340,183,142183,0,1328,144034,142183,g,8811
8812,139822,800,487,0,4414,145523,139822,a,8812
8813,3233,294,533,0,142503,146563,142503,t,8813
8814,388,1290,144315,0,616,146609,144315,g,8814
8815,141019,451,4432,0,2421,148323,141019,a,8815
8816,654,154,147651,0,1322,149781,147651,g,8816
8817,148350,590,336,0,313,149589,148350,a,8817
8818,147849,535,451,0,1081,149916,147849,a,8818
8819,4124,143540,1566,0,391,149621,143540,c,8819
8820,144331,742,3278,0,570,148921,144331,a,8820
8821,146863,988,755,0,3747,152353,146863,a,8821
8822,706,400,151225,0,2755,155086,151225,g,8822
8823,1818,1351,1432,0,150807,155408,150807,t,8823
8824,667,530,153687,0,771,155655,153687,g,8824
8825,977,448,152296,0,1474,155195,152296,g,8825
8826,152419,869,713,0,656,154657,152419,a,8826
8827,150016,915,1839,0,2718,155488,150016,a,8827
8828,2292,1611,151173,0,522,155598,151173,g,8828
8829,1841,559,756,0,155499,158655,155499,t,8829
8830,1568,156838,846,0,1000,160252,156838,c,8830
8831,408,248,158263,0,1048,159967,158263,g,8831
8832,520,482,157544,0,880,159426,157544,g,8832
8833,1969,152926,1536,0,1395,157826,152926,c,8833
8834,153426,1257,1624,0,1446,157753,153426,a,8834
8835,2101,153446,1572,0,898,158017,153446,c,8835
8836,607,212,156587,0,581,157987,156587,g,8836
8837,1647,733,1809,0,153253,157442,153253,t,8837
8838,1236,567,154845,0,630,157278,154845,g,8838
8839,153311,1802,846,0,1621,157580,153311,a,8839
8840,1044,514,155744,0,383,157685,155744,g,8840
8841,999,356,155455,0,598,157408,155455,g,8841
8842,1806,153520,1264,0,453,157043,153520,c,8842
8843,747,526,446,0,156198,157917,156198,t,8843
8844,467,660,156717,0,254,158098,156717,g,8844
8845,536,209,834,0,157455,159034,157455,t,8845
8846,885,719,327,0,157810,159741,157810,t,8846
8847,449,213,158470,0,840,159972,158470,g,8847
8848,156673,1562,594,0,1356,160185,156673,a,8848
8849,158197,1384,337,0,551,160469,158197,a,8849
8850,454,175,155821,0,266,156716,155821,g,8850
8851,152054,1422,660,0,477,154613,152054,a,8851
8852,437,203,1384,0,152627,154651,152627,t,8852
8853,151052,1344,360,0,2050,154806,151052,a,8853
8854,444,158,154053,0,389,155044,154053,g,8854
8855,1414,459,736,0,150585,153194,150585,t,8855
8856,151112,1203,381,0,932,153628,151112,a,8856
8857,469,251,152694,0,1487,154901,152694,g,8857
8858,1443,131,149772,0,239,151585,149772,g,8858
8859,1509,535,1420,0,147813,151277,147813,t,8859
8860,1455,700,799,0,148607,151561,148607,t,8860
8861,355,141,488,0,150591,151575,150591,t,8861
8862,890,1517,424,0,148779,151610,148779,t,8862
8863,555,163,150194,0,404,151316,150194,g,8863
8864,744,255,148629,0,288,149916,148629,g,8864
8865,1708,156,141484,0,831,144179,141484,g,8865
8866,139028,1045,833,0,570,141476,139028,a,8866
8867,769,215,138894,0,1736,141614,138894,g,8867
8868,3223,137217,483,0,609,141532,137217,c,8868
8869,447,542,3225,0,137421,141635,137421,t,8869
8870,506,1778,138266,0,1020,141570,138266,g,8870
8871,434,267,138901,0,293,139895,138901,g,8871
8872,1638,433,810,0,135770,138651,135770,t,8872
8873,1307,3122,679,0,133717,138825,133717,t,8873
8874,392,294,137354,0,407,138447,137354,g,8874
8875,132003,766,818,0,3065,136652,132003,a,8875
8876,1207,130830,3767,0,658,136462,130830,c,8876
8877,129443,811,753,0,2875,133882,129443,a,8877
8878,129884,1162,714,0,798,132558,129884,a,8878
8879,508,333,131160,0,483,132484,131160,g,8879
8880,552,237,127209,0,572,128570,127209,g,8880
8881,123102,822,3563,0,1090,128577,123102,a,8881
8882,124878,757,555,0,1883,128073,124878,a,8882
8883,124342,2039,732,0,4326,131439,124342,a,8883
8884,2737,402,130304,0,534,133977,130304,g,8884
8885,594,153,131776,0,400,132923,131776,g,8885
8886,130672,871,896,0,345,132784,130672,a,8886
8887,129096,524,2748,0,390,132758,129096,a,8887
8888,792,167,1151,0,130343,132453,130343,t,8888
8889,1211,127869,3254,0,733,133067,127869,c,8889
8890,1466,174,1225,0,130215,133080,130215,t,8890
8891,2514,128516,1538,0,555,133123,128516,c,8891
8892,816,129378,2328,0,348,132870,129378,c,8892
8893,129127,508,1646,0,669,131950,129127,a,8893
8894,264,496,385,0,131378,132523,131378,t,8894
8895,906,131254,755,0,300,133215,131254,c,8895
8896,211,83,1688,0,130959,132941,130959,t,8896
8897,274,1439,692,0,130708,133113,130708,t,8897
8898,243,136,131633,0,732,132744,131633,g,8898
8899,128437,712,1446,0,1019,131614,128437,a,8899
8900,128090,850,1433,0,1367,131740,128090,a,8900
8901,328,179,131050,0,457,132014,131050,g,8901
8902,206,164,130323,0,308,131001,130323,g,8902
8903,128596,735,645,0,742,130718,128596,a,8903
8904,128714,1043,651,0,245,130653,128714,a,8904
8905,128027,1187,761,0,539,130514,128027,a,8905
8906,303,416,129013,0,376,130108,129013,g,8906
8907,2361,686,639,0,124509,128195,124509,t,8907
8908,204,582,128305,0,467,129558,128305,g,8908
8909,816,538,1191,0,127233,129778,127233,t,8909
8910,468,147,129079,0,380,130074,129079,g,8910
8911,124709,566,1079,0,1098,127452,124709,a,8911
8912,124802,656,1103,0,406,126967,124802,a,8912
8913,123744,479,1292,0,1109,126624,123744,a,8913
8914,1527,122153,1512,0,1153,126345,122153,c,8914
8915,122316,1233,1089,0,969,125607,122316,a,8915
8916,765,1201,829,0,123102,125897,123102,t,8916
8917,494,980,124260,0,517,126251,124260,g,8917
8918,1225,407,1344,0,123058,126034,123058,t,8918
8919,345,600,124493,0,467,125905,124493,g,8919
8920,951,564,1307,0,122126,124948,122126,t,8920
8921,356,78,124090,0,414,124938,124090,g,8921
8922,1340,405,1440,0,119869,123054,119869,t,8922
8923,121203,613,540,0,689,123045,121203,a,8923
8924,522,608,2413,0,119076,122619,119076,t,8924
8925,118129,656,1310,0,265,120360,118129,a,8925
8926,115467,539,1599,0,1283,118888,115467,a,8926
8927,1315,116067,1073,0,302,118757,116067,c,8927
8928,113580,479,1812,0,742,116613,113580,a,8928
8929,736,624,564,0,113143,115067,113143,t,8929
8930,283,629,114032,0,292,115236,114032,g,8930
8931,111584,656,1123,0,1325,114688,111584,a,8931
8932,1346,479,523,0,112190,114538,112190,t,8932
8933,451,1979,109896,0,1328,113654,109896,g,8933
8934,596,144,112329,0,2452,115521,112329,g,8934
8935,370,144,114278,0,887,115679,114278,g,8935
8936,112606,1097,1098,0,1264,116065,112606,a,8936
8937,114354,758,1051,0,626,116789,114354,a,8937
8938,114309,748,1022,0,678,116757,114309,a,8938
8939,114075,728,1291,0,1544,117638,114075,a,8939
8940,116359,871,556,0,1374,119160,116359,a,8940
8941,237,154,119021,0,960,120372,119021,g,8941
8942,116736,847,486,0,1104,119173,116736,a,8942
8943,282,97,118703,0,673,119755,118703,g,8943
8944,113353,738,430,0,3259,117780,113353,a,8944
8945,338,145,117498,0,547,118528,117498,g,8945
8946,115065,775,332,0,2418,118590,115065,a,8946
8947,116261,590,1127,0,940,118918,116261,a,8947
8948,613,435,117515,0,297,118860,117515,g,8948
8949,114506,537,512,0,1463,117018,114506,a,8949
8950,116620,816,610,0,1046,119092,116620,a,8950
8951,475,506,116262,0,1571,118814,116262,g,8951
8952,2566,113451,1191,0,621,117829,113451,c,8952
8953,532,1145,1609,0,113251,116537,113251,t,8953
8954,111838,2814,597,0,1582,116831,111838,a,8954
8955,428,301,115330,0,2180,118239,115330,g,8955
8956,846,726,107964,0,1495,111031,107964,g,8956
8957,1245,852,105747,0,833,108677,105747,g,8957
8958,1824,146,106120,0,582,108672,106120,g,8958
8959,105598,802,571,0,3274,110245,105598,a,8959
8960,336,458,109919,0,621,111334,109919,g,8960
8961,2531,838,1973,0,105369,110711,105369,t,8961
8962,881,431,1935,0,110712,113959,110712,t,8962
8963,729,114273,918,0,972,116892,114273,c,8963
8964,389,237,116058,0,666,117350,116058,g,8964
8965,421,363,113704,0,2503,116991,113704,g,8965
8966,2146,110721,1635,0,1076,115578,110721,c,8966
8967,109166,557,1449,0,1490,112662,109166,a,8967
8968,108366,723,1637,0,2336,113062,108366,a,8968
8969,1124,412,111850,0,1302,114688,111850,g,8969
8970,589,180,112465,0,1459,114693,112465,g,8970
8971,1574,109358,2357,0,688,113977,109358,c,8971
8972,110071,309,1824,0,323,112527,110071,a,8972
8973,109813,430,1631,0,551,112425,109813,a,8973
8974,110000,729,1077,0,613,112419,110000,a,8974
8975,109268,845,994,0,1645,112752,109268,a,8975
8976,905,723,110166,0,601,112395,110166,g,8976
8977,1570,416,107252,0,1177,110415,107252,g,8977
8978,982,106201,2038,0,1430,110651,106201,c,8978
8979,106599,580,1290,0,1656,110125,106599,a,8979
8980,708,139,108311,0,972,110130,108311,g,8980
8981,2566,101981,745,0,2094,107386,101981,c,8981
8982,105597,477,669,0,338,107081,105597,a,8982
8983,231,187,106317,0,285,107020,106317,g,8983
8984,104032,978,1376,0,1755,108141,104032,a,8984
8985,382,189,107100,0,1547,109218,107100,g,8985
8986,1772,105333,523,0,1196,108824,105333,c,8986
8987,1913,104352,1137,0,1651,109053,104352,c,8987
8988,105068,994,2161,0,669,108892,105068,a,8988
8989,490,301,2388,0,105796,108975,105796,t,8989
8990,105778,560,2152,0,455,108945,105778,a,8990
8991,477,219,2525,0,108040,111261,108040,t,8991
8992,668,569,110240,0,2404,113881,110240,g,8992
8993,309,166,113327,0,324,114126,113327,g,8993
8994,1851,320,1762,0,109984,113917,109984,t,8994
8995,111888,706,531,0,1298,114423,111888,a,8995
8996,2436,110037,2041,0,400,114914,110037,c,8996
8997,112397,592,1326,0,1820,116135,112397,a,8997
8998,1350,452,492,0,115865,118159,115865,t,8998
8999,333,1084,116894,0,223,118534,116894,g,8999
9000,760,467,320,0,117190,118737,117190,t,9000
9001,1240,1218,116196,0,956,119610,116196,g,9001
9002,244,107,118552,0,1524,120427,118552,g,9002
9003,985,117739,1156,0,528,120408,117739,c,9003
9004,427,156,995,0,118635,120213,118635,t,9004
9005,425,1022,816,0,117988,120251,117988,t,9005
9006,562,188,119134,0,363,120247,119134,g,9006
9007,265,154,118703,0,1161,120283,118703,g,9007
9008,117470,1134,732,0,1131,120467,117470,a,9008
9009,476,186,119501,0,1257,121420,119501,g,9009
9010,1413,118167,1061,0,363,121004,118167,c,9010
9011,118451,980,464,0,1483,121378,118451,a,9011
9012,1566,119481,329,0,1345,122721,119481,c,9012
9013,380,205,122109,0,600,123294,122109,g,9013
9014,1205,121288,467,0,284,123244,121288,c,9014
9015,946,1103,733,0,120029,122811,120029,t,9015
9016,259,180,464,0,122331,123234,122331,t,9016
9017,851,121937,278,0,386,123452,121937,c,9017
9018,305,179,494,0,122691,123669,122691,t,9018
9019,226,160,157,0,123365,123908,123365,t,9019
9020,123074,600,235,0,192,124101,123074,a,9020
9021,462,131,123294,0,197,124084,123294,g,9021
9022,122260,868,250,0,2321,125699,122260,a,9022
9023,223,113,126069,0,395,126800,126069,g,9023
9024,844,426,508,0,124917,126695,124917,t,9024
9025,189,201,330,0,126610,127330,126610,t,9025
9026,181,150,237,0,127244,127812,127244,t,9026
9027,308,138,127083,0,332,127861,127083,g,9027
9028,126269,614,285,0,257,127425,126269,a,9028
9029,126418,532,161,0,163,127274,126418,a,9029
9030,508,171,125700,0,368,126747,125700,g,9030
9031,1264,124336,237,0,451,126288,124336,c,9031
9032,837,124698,422,0,1705,127662,124698,c,9032
9033,817,126940,314,0,373,128444,126940,c,9033
9034,314,229,325,0,127619,128487,127619,t,9034
9035,127004,700,192,0,1796,129692,127004,a,9035
9036,399,262,129395,0,480,130536,129395,g,9036
9037,188,88,130128,0,325,130729,130128,g,9037
9038,129022,1083,266,0,359,130730,129022,a,9038
9039,431,166,577,0,129990,131164,129990,t,9039
9040,149,78,157,0,141320,141704,141320,t,9040
9041,831,145204,163,0,366,146564,145204,c,9041
9042,158,120,640,0,145867,146785,145867,t,9042
9043,128,115,188,0,146638,147069,146638,t,9043
9044,171,93,146210,0,573,147047,146210,g,9044
9045,143977,938,276,0,638,145829,143977,a,9045
9046,144317,803,311,0,2402,147833,144317,a,9046
9047,234,71,293,0,148332,148930,148332,t,9047
9048,112,66,147968,0,310,148456,147968,g,9048
9049,146383,752,310,0,966,148411,146383,a,9049
9050,147712,670,169,0,470,149021,147712,a,9050
9051,420,123,148256,0,620,149419,148256,g,9051
9052,139836,913,212,0,292,141253,139836,a,9052
9053,404,164,1436,0,140885,142889,140885,t,9053
9054,1486,141279,230,0,824,143819,141279,c,9054
9055,140757,1009,807,0,2244,144817,140757,a,9055
9056,743,142073,1570,0,1133,145519,142073,c,9056
9057,1585,523,1109,0,140874,144091,140874,t,9057
9058,518,300,142836,0,1379,145033,142836,g,9058
9059,279,538,143050,0,532,144399,143050,g,9059
9060,1389,259,1084,0,141578,144310,141578,t,9060
9061,324,1124,743,0,142609,144800,142609,t,9061
9062,918,141903,1642,0,576,145039,141903,c,9062
9063,330,182,1457,0,143263,145232,143263,t,9063
9064,1260,141652,1913,0,734,145559,141652,c,9064
9065,1570,142081,674,0,1506,145831,142081,c,9065
9066,143706,1105,450,0,932,146193,143706,a,9066
9067,330,106,145429,0,873,146738,145429,g,9067
9068,144535,987,961,0,1237,147720,144535,a,9068
9069,440,162,147150,0,528,148280,147150,g,9069
9070,146051,1005,374,0,1309,148739,146051,a,9070
9071,838,106,147708,0,825,149477,147708,g,9071
9072,147552,751,249,0,969,149521,147552,a,9072
9073,146667,988,911,0,1870,150436,146667,a,9073
9074,1313,148132,785,0,321,150551,148132,c,9074
9075,665,315,724,0,149613,151317,149613,t,9075
9076,855,149198,587,0,6306,156946,149198,c,9076
9077,919,156801,951,0,376,159047,156801,c,9077
9078,376,140,493,0,157990,158999,157990,t,9078
9079,483,264,441,0,157672,158860,157672,t,9079
9080,219,144,157822,0,485,158670,157822,g,9080
9081,155884,1582,606,0,762,158834,155884,a,9081
9082,271,149,157941,0,511,158872,157941,g,9082
9083,754,581,1116,0,156262,158713,156262,t,9083
9084,191,133,156712,0,286,157322,156712,g,9084
9085,180,217,156312,0,376,157085,156312,g,9085
9086,154772,1440,427,0,613,157252,154772,a,9086
9087,298,110,156665,0,440,157513,156665,g,9087
9088,598,280,427,0,156390,157695,156390,t,9088
9089,148,104,157227,0,491,157970,157227,g,9089
9090,270,165,157230,0,425,158090,157230,g,9090
9091,156046,1103,311,0,1101,158561,156046,a,9091
9092,157145,1098,242,0,4634,163119,157145,a,9092
9093,730,200,163433,0,2068,166431,163433,g,9093
9094,240,187,166245,0,1622,168294,166245,g,9094
9095,165860,1409,603,0,778,168650,165860,a,9095
9096,526,139,167915,0,409,168989,167915,g,9096
9097,166516,1224,487,0,354,168581,166516,a,9097
9098,166783,1026,190,0,912,168911,166783,a,9098
9099,638,242,167860,0,1289,170029,167860,g,9099
9100,1267,216,167306,0,575,169364,167306,g,9100
9101,418,140,168101,0,466,169125,168101,g,9101
9102,1484,166365,384,0,430,168663,166365,c,9102
9103,674,832,768,0,166302,168576,166302,t,9103
9104,349,225,167063,0,649,168286,167063,g,9104
9105,1286,164716,914,0,515,167431,164716,c,9105
9106,164331,1614,750,0,337,167032,164331,a,9106
9107,2236,163218,743,0,448,166645,163218,c,9107
9108,162291,1424,953,0,702,165370,162291,a,9108
9109,163701,1203,360,0,1169,166433,163701,a,9109
9110,659,294,164984,0,1561,167498,164984,g,9110
9111,1473,165130,666,0,283,167552,165130,c,9111
9112,682,414,756,0,165173,167025,165173,t,9112
9113,164707,1306,220,0,401,166634,164707,a,9113
9114,358,312,165563,0,985,167218,165563,g,9114
9115,427,188,164118,0,435,165168,164118,g,9115
9116,1250,724,1915,0,157822,161711,157822,t,9116
9117,916,352,530,0,159683,161481,159683,t,9117
9118,160862,796,630,0,475,162763,160862,a,9118
9119,1397,158342,2387,0,796,162922,158342,c,9119
9120,159958,1901,751,0,1249,163859,159958,a,9120
9121,574,131,1052,0,162346,164103,162346,t,9121
9122,326,2184,1059,0,160483,164052,160483,t,9122
9123,334,130,2860,0,160612,163936,160612,t,9123
9124,708,287,2489,0,161828,165312,161828,t,9124
9125,164044,720,443,0,1185,166392,164044,a,9125
9126,165049,758,558,0,245,166610,165049,a,9126
9127,706,153,165045,0,247,166151,165045,g,9127
9128,163200,1216,661,0,849,165926,163200,a,9128
9129,788,241,164691,0,441,166161,164691,g,9129
9130,161902,1748,440,0,1383,165473,161902,a,9130
9131,1808,162735,1478,0,726,166747,162735,c,9131
9132,416,272,164582,0,1148,166418,164582,g,9132
9133,1792,1309,1501,0,161464,166066,161464,t,9133
9134,556,332,163944,0,985,165817,163944,g,9134
9135,159914,584,794,0,2518,163810,159914,a,9135
9136,531,121,162519,0,1500,164671,162519,g,9136
9137,3098,155596,892,0,2045,161631,155596,c,9137
9138,157686,1036,1522,0,1291,161535,157686,a,9138
9139,157198,1768,2207,0,1493,162666,157198,a,9139
9140,606,184,161652,0,581,163023,161652,g,9140
9141,158545,1158,2389,0,1070,163162,158545,a,9141
9142,161004,1117,622,0,894,163637,161004,a,9142
9143,161521,1361,506,0,294,163682,161521,a,9143
9144,830,154,162117,0,304,163405,162117,g,9144
9145,159181,1461,606,0,2239,163487,159181,a,9145
9146,579,330,162984,0,1193,165086,162984,g,9146
9147,928,1266,157893,0,1511,161598,157893,g,9147
9148,548,161,155220,0,775,156704,155220,g,9148
9149,151058,1100,745,0,3043,155946,151058,a,9149
9150,4661,1156,149212,0,1941,156970,149212,g,9150
9151,621,440,154893,0,775,156729,154893,g,9151
9152,152560,991,932,0,4196,158679,152560,a,9152
9153,1268,223,157167,0,1714,160372,157167,g,9153
9154,2139,153998,1397,0,1161,158695,153998,c,9154
9155,153115,1292,2261,0,1166,157834,153115,a,9155
9156,151156,1552,2888,0,1885,157481,151156,a,9156
9157,1164,1346,1808,0,153162,157480,153162,t,9157
9158,323,150,156523,0,344,157340,156523,g,9158
9159,2138,405,1103,0,153485,157131,153485,t,9159
9160,153299,657,1968,0,362,156286,153299,a,9160
9161,1004,340,2266,0,153475,157085,153475,t,9161
9162,1175,612,154646,0,1682,158115,154646,g,9162
9163,1380,151945,1965,0,3663,158953,151945,c,9163
9164,2496,155060,1252,0,775,159583,155060,c,9164
9165,554,156,155860,0,417,156987,155860,g,9165
9166,152292,1097,896,0,1301,155586,152292,a,9166
9167,1388,478,1339,0,152468,155673,152468,t,9167
9168,1394,792,152080,0,679,154945,152080,g,9168
9169,150931,600,934,0,1717,154182,150931,a,9169
9170,1765,149045,2165,0,951,153926,149045,c,9170
9171,150198,1325,998,0,1582,154103,150198,a,9171
9172,1114,150139,1972,0,3260,156485,150139,c,9172
9173,1497,154617,611,0,792,157517,154617,c,9173
9174,402,368,155923,0,1122,157815,155923,g,9174
9175,1233,154082,1061,0,1058,157434,154082,c,9175
9176,153243,1588,1040,0,830,156701,153243,a,9176
9177,972,377,154544,0,619,156512,154544,g,9177
9178,493,262,152331,0,795,153881,152331,g,9178
9179,149917,952,1319,0,1450,153638,149917,a,9179
9180,1891,2786,873,0,149758,155308,149758,t,9180
9181,1241,941,152579,0,957,155718,152579,g,9181
9182,811,334,154152,0,448,155745,154152,g,9182
9183,988,238,153158,0,434,154818,153158,g,9183
9184,150265,1257,1007,0,903,153432,150265,a,9184
9185,2859,148017,1224,0,486,152586,148017,c,9185
9186,141829,840,921,0,5295,148885,141829,a,9186
9187,1834,145431,3114,0,916,151295,145431,c,9187
9188,149107,851,910,0,282,151150,149107,a,9188
9189,147927,926,1128,0,1551,151532,147927,a,9189
9190,1029,455,149920,0,682,152086,149920,g,9190
9191,146983,764,1545,0,1224,150516,146983,a,9191
9192,147331,636,1458,0,384,149809,147331,a,9192
9193,1363,547,993,0,146271,149174,146271,t,9193
9194,1657,145346,1554,0,305,148862,145346,c,9194
9195,144959,651,1479,0,1878,148967,144959,a,9195
9196,1452,143858,2410,0,467,148187,143858,c,9196
9197,139299,1234,1097,0,1468,143098,139299,a,9197
9198,2151,133704,2516,0,2202,140573,133704,c,9198
9199,906,2328,1580,0,136069,140883,136069,t,9199
9200,137047,1381,3064,0,1529,143021,137047,a,9200
9201,523,153,142355,0,607,143638,142355,g,9201
9202,138840,880,538,0,1372,141630,138840,a,9202
9203,138948,1062,1293,0,354,141657,138948,a,9203
9204,748,199,138857,0,955,140759,138857,g,9204
9205,137139,875,454,0,521,138989,137139,a,9205
9206,848,132855,4295,0,912,138910,132855,c,9206
9207,992,134136,2593,0,630,138351,134136,c,9207
9208,710,299,4408,0,135177,140594,135177,t,9208
9209,138706,810,1050,0,631,141197,138706,a,9209
9210,139082,780,774,0,725,141361,139082,a,9210
9211,139625,667,835,0,571,141698,139625,a,9211
9212,135768,561,4962,0,398,141689,135768,a,9212
9213,139705,881,412,0,443,141441,139705,a,9213
9214,135746,679,4629,0,677,141731,135746,a,9214
9215,492,516,828,0,140596,142432,140596,t,9215
9216,290,108,140987,0,691,142076,140987,g,9216
9217,135885,603,546,0,4547,141581,135885,a,9217
9218,140360,805,383,0,708,142256,140360,a,9218
9219,551,141,141395,0,332,142419,141395,g,9219
9220,140796,475,419,0,491,142181,140796,a,9220
9221,137003,616,1161,0,3503,142283,137003,a,9221
9222,138094,3030,783,0,1578,143485,138094,a,9222
9223,637,298,1252,0,141604,143791,141604,t,9223
9224,820,1411,139712,0,968,142911,139712,g,9224
9225,573,143,141377,0,1500,143593,141377,g,9225
9226,1934,610,2037,0,139897,144478,139897,t,9226
9227,140707,1024,1765,0,757,144253,140707,a,9227
9228,140530,564,1440,0,1680,144214,140530,a,9228
9229,1433,141231,1154,0,720,144538,141231,c,9229
9230,142255,713,1057,0,320,144345,142255,a,9230
9231,142233,620,934,0,842,144629,142233,a,9231
9232,142420,841,859,0,904,145024,142420,a,9232
9233,1225,142021,801,0,1038,145085,142021,c,9233
9234,1760,141081,776,0,612,144229,141081,c,9234
9235,141876,503,844,0,1136,144359,141876,a,9235
9236,1201,141479,1020,0,518,144218,141479,c,9236
9237,140463,658,889,0,644,142654,140463,a,9237
9238,538,448,722,0,141484,143192,141484,t,9238
9239,549,639,141750,0,368,143306,141750,g,9239
9240,654,164,141203,0,828,142849,141203,g,9240
9241,139122,880,416,0,435,140853,139122,a,9241
9242,139035,745,619,0,3387,143786,139035,a,9242
9243,950,165,143012,0,883,145010,143012,g,9243
9244,658,280,142044,0,1548,144530,142044,g,9244
9245,143281,740,423,0,1076,145520,143281,a,9245
9246,1049,235,144253,0,558,146095,144253,g,9246
9247,142596,740,399,0,716,144451,142596,a,9247
9248,141584,422,843,0,1294,144143,141584,a,9248
9249,1401,141377,948,0,474,144200,141377,c,9249
9250,140779,485,1471,0,5000,147735,140779,a,9250
9251,1701,146174,1578,0,1821,151274,146174,c,9251
9252,150644,397,346,0,953,152340,150644,a,9252
9253,151352,447,498,0,836,153133,151352,a,9253
9254,1796,297,150584,0,613,153290,150584,g,9254
9255,150855,500,350,0,720,152425,150855,a,9255
9256,149993,536,1759,0,295,152583,149993,a,9256
9257,149833,1104,471,0,1412,152820,149833,a,9257
9258,1704,149364,1443,0,543,153054,149364,c,9258
9259,892,515,875,0,149480,151762,149480,t,9259
9260,149406,1377,486,0,2143,153412,149406,a,9260
9261,1265,219,152228,0,863,154575,152228,g,9261
9262,2217,143629,407,0,1784,148037,143629,c,9262
9263,2001,141803,2573,0,364,146741,141803,c,9263
9264,915,158,143113,0,1129,145315,143113,g,9264
9265,141881,798,476,0,724,143879,141881,a,9265
9266,1296,490,141199,0,2034,145019,141199,g,9266
9267,1865,380,139582,0,944,142771,139582,g,9267
9268,2131,136490,2295,0,1850,142766,136490,c,9268
9269,2229,137385,1462,0,600,141676,137385,c,9269
9270,138176,731,2099,0,530,141536,138176,a,9270
9271,1031,408,1186,0,139691,142316,139691,t,9271
9272,717,1467,1564,0,140243,143991,140243,t,9272
9273,851,342,1984,0,141583,144760,141583,t,9273
9274,948,184,1732,0,141986,144850,141986,t,9274
9275,1475,140555,2206,0,820,145056,140555,c,9275
9276,142837,471,811,0,1692,145811,142837,a,9276
9277,143566,484,1079,0,343,145472,143566,a,9277
9278,143477,661,1156,0,237,145531,143477,a,9278
9279,913,152,1811,0,142630,145506,142630,t,9279
9280,598,546,1436,0,142811,145391,142811,t,9280
9281,143683,713,668,0,315,145379,143683,a,9281
9282,142998,512,1156,0,636,145302,142998,a,9282
9283,1470,142197,636,0,993,145296,142197,c,9283
9284,1849,108,136072,0,237,138266,136072,g,9284
9285,1401,230,1995,0,134789,138415,134789,t,9285
9286,136714,415,788,0,2011,139928,136714,a,9286
9287,996,136617,1330,0,2092,141035,136617,c,9287
9288,1439,138257,962,0,598,141256,138257,c,9288
9289,138296,427,2073,0,1359,142155,138296,a,9289
9290,140191,549,1716,0,2365,144821,140191,a,9290
9291,144994,526,246,0,1013,146779,144994,a,9291
9292,145795,476,212,0,1816,148299,145795,a,9292
9293,1348,145161,1495,0,429,148433,145161,c,9293
9294,146572,413,164,0,497,147646,146572,a,9294
9295,145063,777,1323,0,571,147734,145063,a,9295
9296,554,988,145919,0,1482,148943,145919,g,9296
9297,378,141,148553,0,344,149416,148553,g,9297
9298,2541,815,447,0,146187,149990,146187,t,9298
9299,642,986,148306,0,258,150192,148306,g,9299
9300,349,137,149239,0,583,150308,149239,g,9300
9301,1481,472,445,0,148477,150875,148477,t,9301
9302,380,294,149852,0,970,151496,149852,g,9302
9303,893,150137,207,0,765,152002,150137,c,9303
9304,362,133,151556,0,406,152457,151556,g,9304
9305,980,387,500,0,151166,153033,151166,t,9305
9306,490,129,152554,0,395,153568,152554,g,9306
9307,730,266,930,0,153521,155447,153521,t,9307
9308,345,136,155708,0,1902,158091,155708,g,9308
9309,813,157165,515,0,622,159115,157165,c,9309
9310,158199,421,95,0,228,158943,158199,a,9310
9311,157596,650,452,0,145,158843,157596,a,9311
9312,157753,814,104,0,337,159008,157753,a,9312
9313,588,170,157877,0,490,159125,157877,g,9313
9314,154877,816,147,0,2308,158148,154877,a,9314
9315,939,156796,745,0,2440,160920,156796,c,9315
9316,1472,157909,700,0,790,160871,157909,c,9316
9317,158861,498,827,0,312,160498,158861,a,9317
9318,159220,589,428,0,1589,161826,159220,a,9318
9319,1429,159492,736,0,880,162537,159492,c,9319
9320,156434,1112,427,0,2004,159977,156434,a,9320
9321,1228,155705,2106,0,1519,160558,155705,c,9321
9322,1444,156590,2019,0,628,160681,156590,c,9322
9323,158893,759,531,0,562,160745,158893,a,9323
9324,158772,993,420,0,578,160763,158772,a,9324
9325,1015,316,158622,0,876,160829,158622,g,9325
9326,155688,1090,415,0,1544,158737,155688,a,9326
9327,776,258,157249,0,1288,159571,157249,g,9327
9328,817,1170,156786,0,941,159714,156786,g,9328
9329,2030,154686,1800,0,1145,159661,154686,c,9329
9330,154730,1300,739,0,2941,159710,154730,a,9330
9331,1558,155361,2281,0,1001,160201,155361,c,9331
9332,155346,1290,1866,0,1421,159923,155346,a,9332
9333,711,189,157998,0,904,159802,157998,g,9333
9334,2137,774,2192,0,154311,159414,154311,t,9334
9335,156875,534,1052,0,1589,160050,156875,a,9335
9336,156992,932,1203,0,2703,161830,156992,a,9336
9337,1200,799,2322,0,160305,164626,160305,t,9337
9338,1358,460,162866,0,405,165089,162866,g,9338
9339,1277,293,160365,0,1344,163279,160365,g,9339
9340,159756,766,1297,0,595,162414,159756,a,9340
9341,2489,1163,2425,0,156956,163033,156956,t,9341
9342,159344,946,1361,0,920,162571,159344,a,9342
9343,868,211,2076,0,159607,162762,159607,t,9343
9344,1973,159349,900,0,938,163160,159349,c,9344
9345,158926,516,2989,0,731,163162,158926,a,9345
9346,700,722,1696,0,160420,163538,160420,t,9346
9347,159647,775,2549,0,390,163361,159647,a,9347
9348,962,245,976,0,168223,170406,168223,t,9348
9349,2703,170088,462,0,749,174002,170088,c,9349
9350,361,195,172977,0,636,174169,172977,g,9350
9351,168126,1142,1837,0,2811,173916,168126,a,9351
9352,998,267,172687,0,1118,175070,172687,g,9352
9353,167525,885,673,0,1927,171010,167525,a,9353
9354,169415,790,652,0,946,171803,169415,a,9354
9355,1036,412,169184,0,830,171462,169184,g,9355
9356,166983,1153,1243,0,745,170124,166983,a,9356
9357,757,213,168021,0,498,169489,168021,g,9357
9358,163701,1100,695,0,1704,167200,163701,a,9358
9359,1518,162020,2326,0,5899,171763,162020,c,9359
9360,1659,168191,2818,0,2194,174862,168191,c,9360
9361,170408,834,3107,0,974,175323,170408,a,9361
9362,171736,1398,1058,0,1143,175335,171736,a,9362
9363,172356,1593,672,0,704,175325,172356,a,9363
9364,1085,299,172978,0,863,175225,172978,g,9364
9365,169273,1640,412,0,823,172148,169273,a,9365
9366,596,625,169984,0,1876,173081,169984,g,9366
9367,1041,760,170339,0,523,172663,170339,g,9367
9368,2848,1137,1169,0,167697,172851,167697,t,9368
9369,168452,2882,1000,0,1306,173640,168452,a,9369
9370,887,363,171469,0,1924,174643,171469,g,9370
9371,2266,1230,1627,0,173046,178169,173046,t,9371
9372,685,732,177988,0,3840,183245,177988,g,9372
9373,1427,365,180151,0,1619,183562,180151,g,9373
9374,178438,929,1258,0,3147,183772,178438,a,9374
9375,3696,178886,1416,0,589,184587,178886,c,9375
9376,178628,922,1847,0,417,181814,178628,a,9376
9377,178976,843,908,0,2803,183530,178976,a,9377
9378,1364,394,182200,0,312,184270,182200,g,9378
9379,2858,555,671,0,179335,183419,179335,t,9379
9380,1023,1391,2328,0,178945,183687,178945,t,9380
9381,595,740,180325,0,1793,183453,180325,g,9381
9382,1071,164,181238,0,376,182849,181238,g,9382
9383,1738,445,1306,0,177817,181306,177817,t,9383
9384,178212,897,633,0,1014,180756,178212,a,9384
9385,1586,175331,1796,0,1586,180299,175331,c,9385
9386,2238,174781,1414,0,1388,179821,174781,c,9386
9387,505,195,1359,0,177613,179672,177613,t,9387
9388,176921,1436,871,0,1200,180428,176921,a,9388
9389,782,261,1288,0,181138,183469,181138,t,9389
9390,949,560,182067,0,622,184198,182067,g,9390
9391,550,198,182565,0,726,184039,182565,g,9391
9392,181344,764,605,0,2398,185111,181344,a,9392
9393,1932,182016,1098,0,581,185627,182016,c,9393
9394,960,348,1087,0,183911,186306,183911,t,9394
9395,1263,184125,1080,0,2234,188702,184125,c,9395
9396,187403,895,618,0,455,189371,187403,a,9396
9397,187452,685,780,0,247,189164,187452,a,9397
9398,960,256,974,0,186801,188991,186801,t,9398
9399,186561,691,516,0,4397,192165,186561,a,9399
9400,988,191186,733,0,1255,194162,191186,c,9400
9401,468,546,508,0,192776,194298,192776,t,9401
9402,321,195,656,0,193108,194280,193108,t,9402
9403,385,217,381,0,194043,195026,194043,t,9403
9404,1245,191801,557,0,439,194042,191801,c,9404
9405,191892,675,528,0,1048,194143,191892,a,9405
9406,1051,191464,577,0,782,193874,191464,c,9406
9407,1220,191209,753,0,248,193430,191209,c,9407
9408,191279,659,462,0,472,192872,191279,a,9408
9409,190881,741,595,0,317,192534,190881,a,9409
9410,705,202,768,0,190910,192585,190910,t,9410
9411,190787,744,294,0,2587,194412,190787,a,9411
9412,363,542,875,0,196504,198284,196504,t,9412
9413,345,293,198157,0,411,199206,198157,g,9413
9414,471,188,198122,0,329,199110,198122,g,9414
9415,196851,826,271,0,678,198626,196851,a,9415
9416,196677,920,334,0,971,198902,196677,a,9416
9417,1422,281,196616,0,1133,199452,196616,g,9417
9418,2163,193684,303,0,833,196983,193684,c,9418
9419,1728,193888,1267,0,1133,198016,193888,c,9419
9420,1157,195363,983,0,1347,198850,195363,c,9420
9421,196825,709,1163,0,594,199291,196825,a,9421
9422,195790,463,589,0,1589,198431,195790,a,9422
9423,1184,195933,631,0,421,198169,195933,c,9423
9424,1225,164,1380,0,193517,196286,193517,t,9424
9425,192774,599,1950,0,1354,196677,192774,a,9425
9426,194959,655,694,0,368,196676,194959,a,9426
9427,1371,209,446,0,195886,197912,195886,t,9427
9428,1349,195071,1241,0,775,198436,195071,c,9428
9429,194295,831,1505,0,1568,198199,194295,a,9429
9430,578,159,197133,0,266,198136,197133,g,9430
9431,194063,1589,474,0,968,197094,194063,a,9431
9432,2098,192275,1449,0,917,196739,192275,c,9432
9433,192961,1302,376,0,996,195635,192961,a,9433
9434,432,713,193828,0,470,195443,193828,g,9434
9435,191651,1549,1248,0,976,195424,191651,a,9435
9436,710,474,673,0,193967,195824,193967,t,9436
9437,793,733,193688,0,317,195531,193688,g,9437
9438,786,222,190653,0,2698,194359,190653,g,9438
9439,191105,1481,468,0,2465,195519,191105,a,9439
9440,1175,440,193661,0,1735,197011,193661,g,9440
9441,1929,673,191256,0,1099,194957,191256,g,9441
9442,884,355,190271,0,1091,192601,190271,g,9442
9443,188833,1282,1005,0,1975,193095,188833,a,9443
9444,1823,366,190921,0,1086,194196,190921,g,9444
9445,191162,1009,670,0,710,193551,191162,a,9445
9446,189677,1251,1234,0,5112,197274,189677,a,9446
9447,1887,428,197115,0,1768,201198,197115,g,9447
9448,891,287,198761,0,2536,202475,198761,g,9448
9449,198983,2770,433,0,3891,206077,198983,a,9449
9450,893,284,206403,0,317,207897,206403,g,9450
9451,1539,580,443,0,204724,207286,204724,t,9451
9452,1392,204511,1229,0,1019,208151,204511,c,9452
9453,707,386,2219,0,204859,208171,204859,t,9453
9454,756,232,680,0,207430,209098,207430,t,9454
9455,1257,205834,2110,0,1136,210337,205834,c,9455
9456,207810,555,1221,0,1562,211148,207810,a,9456
9457,209960,763,462,0,574,211759,209960,a,9457
9458,209499,665,1107,0,417,211688,209499,a,9458
9459,210215,587,665,0,388,211855,210215,a,9459
9460,698,249,210693,0,253,211893,210693,g,9460
9461,2377,207237,327,0,529,210470,207237,c,9461
9462,207313,613,1969,0,245,210140,207313,a,9462
9463,561,179,341,0,208670,209751,208670,t,9463
9464,586,459,1217,0,208070,210332,208070,t,9464
9465,1343,207755,752,0,1239,211089,207755,c,9465
9466,209220,798,406,0,479,210903,209220,a,9466
9467,748,241,208605,0,677,210271,208605,g,9467
9468,1870,206988,325,0,513,209696,206988,c,9468
9469,204315,675,803,0,1963,207756,204315,a,9469
9470,1113,205046,835,0,3160,210154,205046,c,9470
9471,2076,205069,666,0,1828,209639,205069,c,9471
9472,970,925,1233,0,206497,209625,206497,t,9472
9473,530,237,207360,0,423,208550,207360,g,9473
9474,204414,959,1147,0,963,207483,204414,a,9474
9475,1524,202926,1995,0,1472,207917,202926,c,9475
9476,202379,1804,1012,0,1694,206889,202379,a,9476
9477,363,114,206524,0,322,207323,206524,g,9477
9478,913,787,806,0,203732,206238,203732,t,9478
9479,2022,203601,1068,0,412,207103,203601,c,9479
9480,202667,1003,1499,0,1494,206663,202667,a,9480
9481,1616,200510,1608,0,1027,204761,200510,c,9481
9482,197653,1066,2123,0,2387,203229,197653,a,9482
9483,425,145,202435,0,2717,205722,202435,g,9483
9484,203525,1409,429,0,1847,207210,203525,a,9484
9485,203272,989,2673,0,4146,211080,203272,a,9485
9486,915,337,210550,0,2068,213870,210550,g,9486
9487,211196,856,787,0,1088,213927,211196,a,9487
9488,211073,890,1483,0,776,214222,211073,a,9488
9489,212646,1047,665,0,270,214628,212646,a,9489
9490,860,260,3167,0,210989,215276,210989,t,9490
9491,1496,212165,280,0,1530,215471,212165,c,9491
9492,590,324,213641,0,931,215486,213641,g,9492
9493,1511,209027,722,0,3379,214639,209027,c,9493
9494,1988,208270,1041,0,1230,212529,208270,c,9494
9495,608,302,207116,0,1183,209209,207116,g,9495
9496,1786,1119,1068,0,204296,208269,204296,t,9496
9497,471,233,206645,0,1058,208407,206645,g,9497
9498,1711,201509,1912,0,3410,208542,201509,c,9498
9499,206172,597,1325,0,2019,210113,206172,a,9499
9500,207478,840,1575,0,618,210511,207478,a,9500
9501,207235,1105,1772,0,441,210553,207235,a,9501
9502,207988,1038,638,0,2272,211936,207988,a,9502
9503,1408,206882,3664,0,971,212925,206882,c,9503
9504,2554,660,672,0,208959,212845,208959,t,9504
9505,493,1119,211001,0,1723,214336,211001,g,9505
9506,1031,348,210125,0,2159,213663,210125,g,9506
9507,1963,636,2336,0,208030,212965,208030,t,9507
9508,596,461,926,0,211001,212984,211001,t,9508
9509,209962,1112,715,0,1405,213194,209962,a,9509
9510,448,211,212023,0,2193,214875,212023,g,9510
9511,3045,209957,1510,0,1185,215697,209957,c,9511
9512,212345,899,671,0,2061,215976,212345,a,9512
9513,212095,2645,357,0,936,216033,212095,a,9513
9514,690,201,213891,0,1479,216261,213891,g,9514
9515,211151,2731,438,0,944,215264,211151,a,9515
9516,439,207,213462,0,604,214712,213462,g,9516
9517,1981,1525,1285,0,208182,212973,208182,t,9517
9518,209602,1503,866,0,1971,213942,209602,a,9518
9519,834,299,211937,0,1066,214136,211937,g,9519
9520,2755,263,208831,0,812,212661,208831,g,9520
9521,1306,448,203064,0,2728,207546,203064,g,9521
9522,7067,190947,266,0,2052,200332,190947,c,9522
9523,1153,316,193159,0,5331,199959,193159,g,9523
9524,1845,196502,1162,0,1482,200991,196502,c,9524
9525,729,411,199115,0,566,200821,199115,g,9525
9526,192146,1221,6142,0,719,200228,192146,a,9526
9527,196241,1417,1277,0,939,199874,196241,a,9527
9528,196784,1279,549,0,1292,199904,196784,a,9528
9529,695,275,198133,0,1004,200107,198133,g,9529
9530,4501,413,194033,0,704,199651,194033,g,9530
9531,2602,881,4667,0,191098,199248,191098,t,9531
9532,687,4361,953,0,193482,199483,193482,t,9532
9533,192744,809,5229,0,692,199474,192744,a,9533
9534,634,227,1070,0,201815,203746,201815,t,9534
9535,2348,201056,862,0,442,204708,201056,c,9535
9536,197963,745,4064,0,1667,204439,197963,a,9536
9537,197964,1433,712,0,3498,203607,197964,a,9537
9538,529,163,201937,0,555,203184,201937,g,9538
9539,196413,1184,615,0,3244,201456,196413,a,9539
9540,197034,1081,1899,0,1143,201157,197034,a,9540
9541,1451,828,2299,0,195321,199899,195321,t,9541
9542,1303,527,196552,0,473,198855,196552,g,9542
9543,1134,321,195741,0,1229,198425,195741,g,9543
9544,3891,189310,2563,0,1714,197478,189310,c,9544
9545,4860,187696,2503,0,647,195706,187696,c,9545
9546,188556,1113,1150,0,565,191384,188556,a,9546
9547,2672,343,2452,0,184735,190202,184735,t,9547
9548,3136,183426,2927,0,755,190244,183426,c,9548
9549,181299,1295,1608,0,3228,187430,181299,a,9549
9550,497,1916,184085,0,756,187254,184085,g,9550
9551,3104,1600,4423,0,174241,183368,174241,t,9551
9552,1209,410,181054,0,670,183343,181054,g,9552
9553,4945,543,170547,0,4729,180764,170547,g,9553
9554,175058,1268,1009,0,1167,178502,175058,a,9554
9555,1091,433,176642,0,361,178527,176642,g,9555
9556,171548,1607,574,0,2423,176152,171548,a,9556
9557,3063,552,5525,0,167815,176955,167815,t,9557
9558,1005,6513,169208,0,1281,178007,169208,g,9558
9559,169535,1166,5334,0,1794,177829,169535,a,9559
9560,825,1393,2134,0,172595,176947,172595,t,9560
9561,1344,7843,1642,0,166633,177462,166633,t,9561
9562,217,147,177100,0,435,177899,177100,g,9562
9563,1173,1236,916,0,174925,178250,174925,t,9563
9564,466,589,177114,0,311,178480,177114,g,9564
9565,932,504,1532,0,175475,178443,175475,t,9565
9566,7370,1438,332,0,172527,181667,172527,t,9566
9567,292,775,181628,0,1135,183830,181628,g,9567
9568,590,440,7652,0,176632,185314,176632,t,9568
9569,445,560,184471,0,518,185994,184471,g,9569
9570,183194,1027,350,0,511,185082,183194,a,9570
9571,183156,768,400,0,201,184525,183156,a,9571
9572,181350,872,548,0,638,183408,181350,a,9572
9573,4004,175192,2886,0,1644,183726,175192,c,9573
9574,2825,176801,3981,0,814,184421,176801,c,9574
9575,452,240,1432,0,182066,184190,182066,t,9575
9576,293,127,4787,0,178878,184085,178878,t,9576
9577,516,223,486,0,183064,184289,183064,t,9577
9578,182447,494,215,0,345,183501,182447,a,9578
9579,517,150,181680,0,924,183271,181680,g,9579
9580,181702,822,203,0,1050,183777,181702,a,9580
9581,570,198,320,0,183963,185051,183963,t,9581
9582,812,3923,180564,0,360,185659,180564,g,9582
9583,180498,763,370,0,5437,187068,180498,a,9583
9584,1408,185298,708,0,659,188073,185298,c,9584
9585,181970,1112,2917,0,1885,187884,181970,a,9585
9586,347,144,188022,0,1998,190511,188022,g,9586
9587,468,446,188680,0,578,190172,188680,g,9587
9588,1364,442,2598,0,185586,189990,185586,t,9588
9589,502,306,1017,0,188106,189931,188106,t,9589
9590,992,187214,714,0,346,189266,187214,c,9590
9591,292,203,188173,0,438,189106,188173,g,9591
9592,1050,186455,890,0,1221,189616,186455,c,9592
9593,187701,1488,287,0,1528,191004,187701,a,9593
9594,189622,827,873,0,1079,192401,189622,a,9594
9595,459,234,191100,0,942,192735,191100,g,9595
9596,2169,189586,359,0,592,192706,189586,c,9596
9597,376,199,191616,0,1093,193284,191616,g,9597
9598,1251,191401,310,0,512,193474,191401,c,9598
9599,594,310,686,0,191592,193182,191592,t,9599
9600,265,122,442,0,191592,192421,191592,t,9600
9601,286,162,304,0,191580,192332,191580,t,9601
9602,191151,482,255,0,322,192210,191151,a,9602
9603,190724,780,224,0,1351,193079,190724,a,9603
9604,1296,191486,513,0,377,193672,191486,c,9604
9605,191912,650,263,0,343,193168,191912,a,9605
9606,326,168,191872,0,2828,195194,191872,g,9606
9607,1323,194659,381,0,632,196995,194659,c,9607
9608,436,380,320,0,196104,197240,196104,t,9608
9609,998,195265,494,0,474,197231,195265,c,9609
9610,290,102,703,0,196159,197254,196159,t,9610
9611,195840,462,653,0,308,197263,195840,a,9611
9612,194922,969,527,0,369,196787,194922,a,9612
9613,194317,1115,266,0,404,196102,194317,a,9613
9614,300,353,506,0,194772,195931,194772,t,9614
9615,581,332,189555,0,293,190761,189555,g,9615
9616,189761,671,524,0,967,191923,189761,a,9616
9617,1451,188397,1746,0,387,191981,188397,c,9617
9618,179852,800,872,0,440,181964,179852,a,9618
9619,435,378,422,0,181984,183219,181984,t,9619
9620,468,4928,178123,0,4080,187599,178123,g,9620
9621,369,391,188659,0,1867,191286,188659,g,9621
9622,618,237,190643,0,618,192116,190643,g,9622
9623,188749,1033,442,0,572,190796,188749,a,9623
9624,187783,1439,930,0,433,190585,187783,a,9624
9625,187510,1488,984,0,718,190700,187510,a,9625
9626,618,316,189037,0,2406,192377,189037,g,9626
9627,501,712,190625,0,695,192533,190625,g,9627
9628,1428,630,1616,0,188436,192110,188436,t,9628
9629,3996,391,491,0,187424,192302,187424,t,9629
9630,185995,1451,4116,0,1238,192800,185995,a,9630
9631,516,214,191856,0,2876,195462,191856,g,9631
9632,495,195,189417,0,728,190835,189417,g,9632
9633,184845,1048,2364,0,2955,191212,184845,a,9633
9634,189897,1147,577,0,1272,192893,189897,a,9634
9635,190512,1349,609,0,670,193140,190512,a,9635
9636,1028,252,190883,0,381,192544,190883,g,9636
9637,184882,1012,932,0,1155,187981,184882,a,9637
9638,1311,179808,4542,0,2541,188202,179808,c,9638
9639,175839,1420,3274,0,1253,181786,175839,a,9639
9640,624,150,4226,0,175271,180271,175271,t,9640
9641,174825,1359,1114,0,5496,182794,174825,a,9641
9642,1625,174956,4176,0,2873,183630,174956,c,9642
9643,176730,1910,1621,0,427,180688,176730,a,9643
9644,172382,404,2565,0,3548,178899,172382,a,9644
9645,1837,172620,3751,0,712,178920,172620,c,9645
9646,171437,732,2824,0,2256,177249,171437,a,9646
9647,171069,1443,1897,0,3318,177727,171069,a,9647
9648,970,1343,2716,0,174402,179431,174402,t,9648
9649,1178,2884,174284,0,4120,182466,174284,g,9649
9650,853,290,178516,0,2294,181953,178516,g,9650
9651,2308,894,177264,0,1159,181625,177264,g,9651
9652,176602,1533,1673,0,628,180436,176602,a,9652
9653,176476,672,1103,0,1652,179903,176476,a,9653
9654,1446,173057,4408,0,3971,182882,173057,c,9654
9655,3667,177797,1650,0,851,183965,177797,c,9655
9656,548,302,5300,0,177265,183415,177265,t,9656
9657,625,1571,1390,0,180618,184204,180618,t,9657
9658,1910,178616,2990,0,828,184344,178616,c,9658
9659,178645,647,585,0,4107,183984,178645,a,9659
9660,180050,1909,346,0,677,182982,180050,a,9660
9661,475,163,183159,0,430,184227,183159,g,9661
9662,174307,751,322,0,3132,178512,174307,a,9662
9663,460,461,176676,0,1717,179314,176676,g,9663
9664,2159,819,171399,0,4754,179131,171399,g,9664
9665,173011,858,2316,0,4048,180233,173011,a,9665
9666,918,2545,3887,0,174033,181383,174033,t,9666
9667,1994,690,176738,0,8301,187723,176738,g,9667
9668,528,243,189731,0,1143,191645,189731,g,9668
9669,188513,941,797,0,693,190944,188513,a,9669
9670,187379,701,710,0,2987,191777,187379,a,9670
9671,4860,185491,632,0,652,191635,185491,c,9671
9672,359,277,186962,0,5010,192608,186962,g,9672
9673,190014,1312,1233,0,1847,194406,190014,a,9673
9674,606,507,4963,0,189479,195555,189479,t,9674
9675,1683,1374,842,0,192209,196108,192209,t,9675
9676,941,348,193276,0,1483,196048,193276,g,9676
9677,822,238,191324,0,3091,195475,191324,g,9677
9678,190311,1013,1637,0,3840,196801,190311,a,9678
9679,2886,190948,3019,0,783,197636,190948,c,9679
9680,190219,998,1451,0,1196,193864,190219,a,9680
9681,2571,186589,2657,0,2141,193958,186589,c,9681
9682,189284,1772,1626,0,1090,193772,189284,a,9682
9683,189689,1492,1180,0,3261,195622,189689,a,9683
9684,1142,785,193865,0,670,196462,193865,g,9684
9685,2168,701,1205,0,191003,195077,191003,t,9685
9686,528,344,193224,0,896,194992,193224,g,9686
9687,1568,189116,1243,0,2092,194019,189116,c,9687
9688,2536,189279,618,0,3411,195844,189279,c,9688
9689,1163,191689,2124,0,1099,196075,191689,c,9689
9690,1393,310,1282,0,192611,195596,192611,t,9690
9691,467,515,635,0,193953,195570,193953,t,9691
9692,935,192262,1243,0,954,195394,192262,c,9692
9693,664,223,1005,0,195327,197219,195327,t,9693
9694,490,499,196188,0,583,197760,196188,g,9694
9695,1598,282,1497,0,191785,195162,191785,t,9695
9696,867,143,1148,0,193010,195168,193010,t,9696
9697,1245,191574,1262,0,680,194761,191574,c,9697
9698,191950,583,1148,0,1597,195278,191950,a,9698
9699,1020,191950,1894,0,1000,195864,191950,c,9699
9700,192661,592,811,0,1278,195342,192661,a,9700
9701,1292,191935,1349,0,999,195575,191935,c,9701
9702,1293,192432,1350,0,1345,196420,192432,c,9702
9703,194101,785,1124,0,689,196699,194101,a,9703
9704,269,264,1166,0,194909,196608,194909,t,9704
9705,463,843,768,0,194558,196632,194558,t,9705
9706,246,165,1131,0,195548,197090,195548,t,9706
9707,1065,194721,585,0,2217,198588,194721,c,9707
9708,1303,196735,728,0,742,199508,196735,c,9708
9709,196840,607,1120,0,787,199354,196840,a,9709
9710,776,218,583,0,197683,199260,197683,t,9710
9711,278,304,198216,0,942,199740,198216,g,9711
9712,197193,1237,442,0,2168,201040,197193,a,9712
9713,217,186,200748,0,621,201772,200748,g,9713
9714,595,467,825,0,199918,201805,199918,t,9714
9715,349,157,998,0,200772,202276,200772,t,9715
9716,200141,763,506,0,1099,202509,200141,a,9716
9717,200454,817,549,0,949,202769,200454,a,9717
9718,666,140,495,0,202181,203482,202181,t,9718
9719,912,201243,746,0,704,203605,201243,c,9719
9720,201013,620,723,0,1816,204172,201013,a,9720
9721,386,485,555,0,207600,209026,207600,t,9721
9722,383,323,209828,0,1030,211564,209828,g,9722
9723,208448,867,1105,0,1598,212018,208448,a,9723
9724,209466,1462,490,0,1033,212451,209466,a,9724
9725,209614,1278,422,0,1046,212360,209614,a,9725
9726,487,280,210974,0,593,212334,210974,g,9726
9727,209196,1201,372,0,4894,215663,209196,a,9727
9728,915,215564,858,0,848,218185,215564,c,9728
9729,678,817,214884,0,682,217061,214884,g,9729
9730,1038,237,213064,0,1155,215494,213064,g,9730
9731,208148,2133,1283,0,3218,214782,208148,a,9731
9732,2117,211739,860,0,894,215610,211739,c,9732
9733,616,459,211846,0,4909,217830,211846,g,9733
9734,1036,216642,621,0,1942,220241,216642,c,9734
9735,445,189,218018,0,758,219410,218018,g,9735
9736,802,456,743,0,216908,218909,216908,t,9736
9737,214045,1368,768,0,3230,219411,214045,a,9737
9738,1778,217435,640,0,1128,220981,217435,c,9738
9739,297,371,2430,0,220029,223127,220029,t,9739
9740,383,336,313,0,223482,224514,223482,t,9740
9741,379,247,223260,0,778,224664,223260,g,9741
9742,653,373,859,0,222704,224589,222704,t,9742
9743,222702,916,273,0,1379,225270,222702,a,9743
9744,287,182,224267,0,729,225465,224267,g,9744
9745,1404,482,1127,0,222024,225037,222024,t,9745
9746,289,164,1473,0,222943,224869,222943,t,9746
9747,1882,221487,546,0,962,224877,221487,c,9747
9748,1942,221533,343,0,1025,224843,221533,c,9748
9749,221386,1344,944,0,641,224315,221386,a,9749
9750,553,168,990,0,223421,225132,223421,t,9750
9751,479,318,224129,0,2728,227654,224129,g,9751
9752,1111,224954,531,0,1415,228011,224954,c,9752
9753,225609,775,887,0,666,227937,225609,a,9753
9754,515,230,226011,0,550,227306,226011,g,9754
9755,224446,876,626,0,630,226578,224446,a,9755
9756,223633,1270,616,0,912,226431,223633,a,9756
9757,222836,1349,807,0,2896,227888,222836,a,9757
9758,1143,225803,680,0,1371,228997,225803,c,9758
9759,1759,223263,726,0,737,226485,223263,c,9759
9760,222635,699,1381,0,486,225201,222635,a,9760
9761,222878,1249,532,0,1413,226072,222878,a,9761
9762,500,494,224177,0,878,226049,224177,g,9762
9763,216244,1744,491,0,1514,219993,216244,a,9763
9764,572,407,1414,0,216935,219328,216935,t,9764
9765,621,532,217782,0,898,219833,217782,g,9765
9766,216798,1101,647,0,1384,219930,216798,a,9766
9767,215323,1079,731,0,2595,219728,215323,a,9767
9768,1373,215656,2096,0,816,219941,215656,c,9768
9769,1888,340,1506,0,215570,219304,215570,t,9769
9770,271,245,218517,0,1479,220512,218517,g,9770
9771,217069,2494,459,0,881,220903,217069,a,9771
9772,867,330,1369,0,219449,222015,219449,t,9772
9773,1098,1682,387,0,219709,222876,219709,t,9773
9774,339,993,218650,0,1427,221409,218650,g,9774
9775,455,302,218618,0,1281,220656,218618,g,9775
9776,3247,638,800,0,214717,219402,214717,t,9776
9777,217069,1082,712,0,358,219221,217069,a,9777
9778,908,290,215139,0,927,217264,215139,g,9778
9779,210328,1217,949,0,786,213280,210328,a,9779
9780,621,295,210481,0,5636,217033,210481,g,9780
9781,2643,212272,574,0,3226,218715,212272,c,9781
9782,1989,211998,1431,0,3914,219332,211998,c,9782
9783,2118,213737,1730,0,2009,219594,213737,c,9783
9784,462,352,218097,0,509,219420,218097,g,9784
9785,213135,926,2259,0,2788,219108,213135,a,9785
9786,212867,1514,2592,0,877,217850,212867,a,9786
9787,661,597,1941,0,213769,216968,213769,t,9787
9788,2789,479,1321,0,212194,216783,212194,t,9788
9789,652,301,2409,0,213774,217136,213774,t,9789
9790,1373,213005,2239,0,1058,217675,213005,c,9790
9791,1487,212028,3524,0,1707,218746,212028,c,9791
9792,3647,207952,1643,0,1043,214285,207952,c,9792
9793,205419,874,1430,0,899,208622,205419,a,9793
9794,204347,2447,846,0,722,208362,204347,a,9794
9795,1263,250,205942,0,499,207954,205942,g,9795
9796,673,419,206210,0,903,208205,206210,g,9796
9797,204838,1831,807,0,1383,208859,204838,a,9797
9798,2546,381,203932,0,2619,209478,203932,g,9798
9799,1926,203249,2249,0,1182,208606,203249,c,9799
9800,2597,1097,1167,0,204695,209556,204695,t,9800
9801,734,2229,205658,0,1594,210215,205658,g,9801
9802,1088,2545,203097,0,2193,208923,203097,g,9802
9803,1472,266,204910,0,651,207299,204910,g,9803
9804,3781,1110,1175,0,197937,204003,197937,t,9804
9805,748,3082,199327,0,1175,204332,199327,g,9805
9806,2036,338,200123,0,690,203187,200123,g,9806
9807,1554,693,1421,0,199722,203390,199722,t,9807
9808,1511,198732,2319,0,866,203428,198732,c,9808
9809,1070,314,3236,0,198475,203095,198475,t,9809
9810,1830,798,1014,0,199357,202999,199357,t,9810
9811,2416,1258,2410,0,197265,203349,197265,t,9811
9812,612,242,202422,0,1963,205239,202422,g,9812
9813,2271,199431,3015,0,976,205693,199431,c,9813
9814,1238,154,203640,0,348,205380,203640,g,9814
9815,201323,1236,872,0,923,204354,201323,a,9815
9816,2435,296,201304,0,599,204634,201304,g,9816
9817,198145,1833,1084,0,1610,202672,198145,a,9817
9818,699,204,201112,0,605,202620,201112,g,9818
9819,197645,1422,360,0,2053,201480,197645,a,9819
9820,2708,195790,1878,0,1156,201532,195790,c,9820
9821,1087,471,197001,0,3185,201744,197001,g,9821
9822,1417,327,198714,0,2469,202927,198714,g,9822
9823,1742,198397,568,0,2124,202831,198397,c,9823
9824,2682,193782,2905,0,1028,200397,193782,c,9824
9825,943,531,1481,0,199818,202773,199818,t,9825
9826,1287,812,201493,0,581,204173,201493,g,9826
9827,1216,482,871,0,200473,203042,200473,t,9827
9828,1119,1122,1786,0,199705,203732,199705,t,9828
9829,818,748,1109,0,201790,204465,201790,t,9829
9830,1727,943,200759,0,3045,206474,200759,g,9830
9831,840,838,204738,0,5016,211432,204738,g,9831
9832,1361,713,209883,0,1277,213234,209883,g,9832
9833,1201,509,209933,0,688,212331,209933,g,9833
9834,208033,1636,528,0,793,210990,208033,a,9834
9835,207823,1787,638,0,1021,211269,207823,a,9835
9836,1264,498,209116,0,480,211358,209116,g,9836
9837,2014,572,751,0,210710,214047,210710,t,9837
9838,1436,212474,1255,0,3264,218429,212474,c,9838
9839,1763,213652,1885,0,818,218118,213652,c,9839
9840,769,268,1735,0,214143,216915,214143,t,9840
9841,210721,1466,884,0,1384,214455,210721,a,9841
9842,2225,206415,1296,0,1407,211343,206415,c,9842
9843,1305,373,198672,0,3519,203869,198672,g,9843
9844,2856,197416,1667,0,2158,204097,197416,c,9844
9845,2360,197160,2438,0,3191,205149,197160,c,9845
9846,2155,199851,3405,0,807,206218,199851,c,9846
9847,201460,1384,2342,0,900,206086,201460,a,9847
9848,200298,2045,2289,0,904,205536,200298,a,9848
9849,198858,2666,2907,0,718,205149,198858,a,9849
9850,1811,777,914,0,201194,204696,201194,t,9850
9851,347,463,202931,0,1581,205322,202931,g,9851
9852,2749,1572,1152,0,201203,206676,201203,t,9852
9853,3712,596,201968,0,640,206916,201968,g,9853
9854,531,650,202354,0,1375,204910,202354,g,9854
9855,194754,2760,2357,0,6834,206705,194754,a,9855
9856,801,370,206631,0,2403,210205,206631,g,9856
9857,3814,204151,696,0,1080,209741,204151,c,9857
9858,1439,316,3274,0,204172,209201,204172,t,9858
9859,1520,1504,1155,0,205127,209306,205127,t,9859
9860,559,1995,205857,0,529,208940,205857,g,9860
9861,202795,1666,3387,0,2472,210320,202795,a,9861
9862,1499,405,1206,0,208008,211118,208008,t,9862
9863,357,231,209915,0,566,211069,209915,g,9863
9864,1718,559,1275,0,206809,210361,206809,t,9864
9865,206136,1210,1320,0,3865,212531,206136,a,9865
9866,1118,208336,2505,0,759,212718,208336,c,9866
9867,763,247,2458,0,208606,212074,208606,t,9867
9868,239,152,1723,0,207868,209982,207868,t,9868
9869,2135,206382,582,0,1362,210461,206382,c,9869
9870,2411,206430,987,0,677,210505,206430,c,9870
9871,207368,1256,529,0,944,210097,207368,a,9871
9872,1286,206309,1627,0,345,209567,206309,c,9872
9873,204844,1215,423,0,558,207040,204844,a,9873
9874,436,185,205634,0,404,206659,205634,g,9874
9875,202605,1414,495,0,2850,207364,202605,a,9875
9876,854,205323,1172,0,2527,209876,205323,c,9876
9877,378,378,208180,0,1219,210155,208180,g,9877
9878,1661,532,1082,0,206010,209285,206010,t,9878
9879,654,494,206155,0,1252,208555,206155,g,9879
9880,203783,1365,373,0,2549,208070,203783,a,9880
9881,1143,205137,1167,0,7249,214696,205137,c,9881
9882,3010,205533,651,0,491,209685,205533,c,9882
9883,483,513,744,0,208183,209923,208183,t,9883
9884,1129,207404,402,0,678,209613,207404,c,9884
9885,205521,1715,1732,0,548,209516,205521,a,9885
9886,607,506,207701,0,725,209539,207701,g,9886
9887,1944,778,203510,0,2539,208771,203510,g,9887
9888,2248,202810,1500,0,703,207261,202810,c,9888
9889,1127,1049,1642,0,202138,205956,202138,t,9889
9890,1652,527,203216,0,720,206115,203216,g,9890
9891,1140,383,201597,0,3175,206295,201597,g,9891
9892,2353,201438,397,0,3983,208171,201438,c,9892
9893,2139,591,200030,0,2045,204805,200030,g,9893
9894,508,290,199385,0,2718,202901,199385,g,9894
9895,3078,194928,3632,0,1530,203168,194928,c,9895
9896,2506,769,1873,0,198622,203770,198622,t,9896
9897,201066,1480,785,0,1131,204462,201066,a,9897
9898,199334,1551,3292,0,869,205046,199334,a,9898
9899,3987,505,2167,0,200137,206796,200137,t,9899
9900,979,568,205436,0,1252,208235,205436,g,9900
9901,3073,202767,1679,0,751,208270,202767,c,9901
9902,1266,540,3592,0,204252,209650,204252,t,9902
9903,204142,1674,1157,0,3162,210135,204142,a,9903
9904,719,1758,2450,0,205033,209960,205033,t,9904
9905,1120,385,2649,0,205778,209932,205778,t,9905
9906,1970,350,830,0,206836,209986,206836,t,9906
9907,524,448,206919,0,2117,210008,206919,g,9907
9908,1656,205705,746,0,1852,209959,205705,c,9908
9909,2095,970,482,0,207296,210843,207296,t,9909
9910,1262,207656,1731,0,852,211501,207656,c,9910
9911,524,516,209511,0,750,211301,209511,g,9911
9912,701,615,207542,0,645,209503,207542,g,9912
9913,2346,203594,1260,0,1287,208487,203594,c,9913
9914,204120,2561,1288,0,967,208936,204120,a,9914
9915,1152,354,207078,0,439,209023,207078,g,9915
9916,1114,620,1304,0,205468,208506,205468,t,9916
9917,1825,204427,1084,0,1208,208544,204427,c,9917
9918,1719,204750,1282,0,825,208576,204750,c,9918
9919,1279,204642,1234,0,3551,210706,204642,c,9919
9920,207989,2800,644,0,400,211833,207989,a,9920
9921,1038,443,466,0,209588,211535,209588,t,9921
9922,1351,208197,418,0,593,210559,208197,c,9922
9923,205746,2916,770,0,1661,211093,205746,a,9923
9924,1393,208737,563,0,1923,212616,208737,c,9924
9925,209905,1978,936,0,596,213415,209905,a,9925
9926,660,316,650,0,212229,213855,212229,t,9926
9927,521,682,271,0,212726,214200,212726,t,9927
9928,678,690,210489,0,1504,213361,210489,g,9928
9929,425,326,211853,0,2767,215371,211853,g,9929
9930,387,364,215154,0,497,216402,215154,g,9930
9931,1065,831,1161,0,213100,216157,213100,t,9931
9932,546,217,364,0,214892,216019,214892,t,9932
9933,1081,214130,494,0,1165,216870,214130,c,9933
9934,1124,214293,439,0,550,216406,214293,c,9934
9935,213773,1896,365,0,241,216275,213773,a,9935
9936,213897,1626,274,0,449,216246,213897,a,9936
9937,1976,213595,406,0,383,216360,213595,c,9937
9938,211503,2334,437,0,977,215251,211503,a,9938
9939,213153,1522,497,0,1745,216917,213153,a,9939
9940,794,286,215466,0,548,217094,215466,g,9940
9941,1410,1055,606,0,214780,217851,214780,t,9941
9942,216996,1076,556,0,6057,224685,216996,a,9942
9943,1042,358,226917,0,1441,229758,226917,g,9943
9944,227778,1411,377,0,605,230171,227778,a,9944
9945,227946,1141,506,0,1429,231022,227946,a,9945
9946,2320,228276,795,0,470,231861,228276,c,9946
9947,227279,2081,489,0,1024,230873,227279,a,9947
9948,227999,1455,1106,0,1713,232273,227999,a,9948
9949,2196,229617,548,0,2556,234917,229617,c,9949
9950,1423,232549,1192,0,500,235664,232549,c,9950
9951,1617,1047,687,0,228682,232033,228682,t,9951
9952,506,900,229447,0,1108,231961,229447,g,9952
9953,1734,457,227914,0,512,230617,227914,g,9953
9954,1439,760,705,0,223935,226839,223935,t,9954
9955,1886,222555,1162,0,828,226431,222555,c,9955
9956,1481,220843,3006,0,1102,226432,220843,c,9956
9957,219705,2538,2628,0,776,225647,219705,a,9957
9958,2643,600,1355,0,220355,224953,220355,t,9958
9959,221023,1930,1217,0,941,225111,221023,a,9959
9960,2234,218616,2960,0,930,224740,218616,c,9960
9961,217372,2861,770,0,3675,224678,217372,a,9961
9962,2113,221874,1541,0,5123,230651,221874,c,9962
9963,1103,1818,229247,0,1308,233476,229247,g,9963
9964,2234,223265,2066,0,4997,232562,223265,c,9964
9965,2765,227782,2190,0,845,233582,227782,c,9965
9966,225095,3081,2580,0,573,231329,225095,a,9966
9967,225500,1452,2732,0,1453,231137,225500,a,9967
9968,225850,1687,2131,0,2708,232376,225850,a,9968
9969,2593,226864,1811,0,1904,233172,226864,c,9969
9970,224616,3236,2454,0,551,230857,224616,a,9970
9971,1197,441,2619,0,226040,230297,226040,t,9971
9972,791,730,228370,0,931,230822,228370,g,9972
9973,223740,2154,1198,0,2280,229372,223740,a,9973
9974,224272,1876,1411,0,1154,228713,224272,a,9974
9975,1863,1046,2210,0,224804,229923,224804,t,9975
9976,1646,681,227029,0,578,229934,227029,g,9976
9977,785,386,227043,0,1168,229382,227043,g,9977
9978,224578,2657,980,0,3781,231996,224578,a,9978
9979,2507,959,1434,0,228595,233495,228595,t,9979
9980,1623,924,225986,0,936,229469,225986,g,9980
9981,223225,1294,1070,0,2410,227999,223225,a,9981
9982,3110,221013,3038,0,1131,228292,221013,c,9982
9983,221670,1997,997,0,1872,226536,221670,a,9983
9984,221679,854,913,0,7662,231108,221679,a,9984
9985,2456,228832,1262,0,4202,236752,228832,c,9985
9986,1342,949,233060,0,775,236126,233060,g,9986
9987,909,353,232517,0,807,234586,232517,g,9987
9988,229275,1727,637,0,1209,232848,229275,a,9988
9989,229734,1354,1327,0,575,232990,229734,a,9989
9990,3101,734,227839,0,699,232373,227839,g,9990
9991,228276,1603,838,0,1522,232239,228276,a,9991
9992,2609,226858,1451,0,1232,232150,226858,c,9992
9993,225593,2403,3204,0,957,232157,225593,a,9993
9994,1495,545,1702,0,229418,233160,229418,t,9994
9995,952,1555,229656,0,3865,236028,229656,g,9995
9996,2201,230912,1857,0,4151,239121,230912,c,9996
9997,3703,1091,1832,0,231954,238580,231954,t,9997
9998,1180,501,232483,0,1321,235485,232483,g,9998
9999,230448,2075,869,0,736,234128,230448,a,9999
10000,2588,225971,4500,0,886,233945,225971,c,10000
10001,224758,3137,681,0,2401,230977,224758,a,10001
10002,961,453,229207,0,600,231221,229207,g,10002
10003,2492,899,775,0,228974,233140,228974,t,10003
10004,2073,227461,2868,0,1987,234389,227461,c,10004
10005,1409,2306,1756,0,228722,234193,228722,t,10005
10006,2548,498,230284,0,820,234150,230284,g,10006
10007,751,327,230499,0,773,232350,230499,g,10007
10008,222170,1601,1375,0,561,225707,222170,a,10008
10009,220524,1040,1266,0,2737,225567,220524,a,10009
10010,4472,215805,3468,0,957,224702,215805,c,10010
10011,215189,2153,443,0,2128,219913,215189,a,10011
10012,1002,2312,215885,0,507,219706,215885,g,10012
10013,4547,3641,209087,0,598,217873,209087,g,10013
10014,931,472,214463,0,3414,219280,214463,g,10014
10015,5036,3927,2163,0,210385,221511,210385,t,10015
10016,1226,534,220820,0,1035,223615,220820,g,10016
10017,2074,1965,2546,0,216772,223357,216772,t,10017
10018,3440,2989,216222,0,797,223448,216222,g,10018
10019,902,575,218529,0,4255,224261,218529,g,10019
10020,216766,2498,1336,0,2527,223127,216766,a,10020
10021,2434,1124,6458,0,212322,222338,212322,t,10021
10022,1663,1598,3432,0,215923,222616,215923,t,10022
10023,4123,213098,3342,0,2460,223023,213098,c,10023
10024,215836,2290,3690,0,7665,229481,215836,a,10024
10025,225900,1224,3964,0,2465,233553,225900,a,10025
10026,1655,419,230809,0,870,233753,230809,g,10026
10027,226002,1043,1849,0,1486,230380,226002,a,10027
10028,225189,1107,3088,0,799,230183,225189,a,10028
10029,224308,1500,2641,0,967,229416,224308,a,10029
10030,222973,1362,2601,0,1820,228756,222973,a,10030
10031,3669,220476,2512,0,980,227637,220476,c,10031
10032,4035,212560,2488,0,2529,221612,212560,c,10032
10033,1704,214963,2933,0,2023,221623,214963,c,10033
10034,214942,1979,3434,0,593,220948,214942,a,10034
10035,957,562,851,0,218412,220782,218412,t,10035
10036,1520,1370,216961,0,387,220238,216961,g,10036
10037,1338,284,216353,0,2117,220092,216353,g,10037
10038,214835,1692,1645,0,1079,219251,214835,a,10038
10039,1514,965,2173,0,221576,226228,221576,t,10039
10040,634,707,226818,0,741,228900,226818,g,10040
10041,861,276,226144,0,1168,228449,226144,g,10041
10042,223886,1705,884,0,1694,228169,223886,a,10042
10043,223318,2006,1582,0,4450,231356,223318,a,10043
10044,856,351,230305,0,1022,232534,230305,g,10044
10045,225909,1480,1319,0,12040,240748,225909,a,10045
10046,1814,239492,2217,0,1357,244880,239492,c,10046
10047,241885,1141,1056,0,824,244906,241885,a,10047
10048,241179,1026,1690,0,965,244860,241179,a,10048
10049,240559,1564,1786,0,801,244710,240559,a,10049
10050,240798,1776,928,0,2376,245878,240798,a,10050
10051,2078,241235,1989,0,745,246047,241235,c,10051
10052,1479,955,669,0,238593,241696,238593,t,10052
10053,2353,237162,1244,0,839,241598,237162,c,10053
10054,1668,236535,2115,0,1074,241392,236535,c,10054
10055,233708,1817,1286,0,1560,238371,233708,a,10055
10056,687,241,234094,0,1038,236060,234094,g,10056
10057,1471,2725,1083,0,227743,233022,227743,t,10057
10058,549,298,231804,0,556,233207,231804,g,10058
10059,489,167,231301,0,808,232765,231301,g,10059
10060,230036,1309,492,0,573,232410,230036,a,10060
10061,229640,1319,1143,0,179,232281,229640,a,10061
10062,1582,362,1025,0,228750,231719,228750,t,10062
10063,1425,229122,880,0,398,231825,229122,c,10063
10064,227305,1131,2800,0,529,231765,227305,a,10064
10065,958,515,719,0,229538,231730,229538,t,10065
10066,301,542,230035,0,1133,232011,230035,g,10066
10067,988,185,227654,0,3069,231896,227654,g,10067
10068,2439,272,228658,0,4030,235399,228658,g,10068
10069,233165,871,2238,0,6824,243098,233165,a,10069
10070,756,232,244444,0,1153,246585,244444,g,10070
10071,688,191,245389,0,1176,247444,245389,g,10071
10072,245713,884,520,0,305,247422,245713,a,10072
10073,245248,1045,744,0,542,247579,245248,a,10073
10074,245643,1154,565,0,179,247541,245643,a,10074
10075,929,257,1926,0,246381,249493,246381,t,10075
10076,2711,246523,552,0,1577,251363,246523,c,10076
10077,1540,247460,1920,0,1545,252465,247460,c,10077
10078,1783,249009,566,0,1336,252694,249009,c,10078
10079,249042,1179,1749,0,359,252329,249042,a,10079
10080,954,326,629,0,250221,252130,250221,t,10080
10081,249428,1191,303,0,2164,253086,249428,a,10081
10082,1255,249936,878,0,351,252420,249936,c,10082
10083,742,241,472,0,250787,252242,250787,t,10083
10084,536,840,229,0,250859,252464,250859,t,10084
10085,541,440,251040,0,657,252678,251040,g,10085
10086,453,378,250294,0,1508,252633,250294,g,10086
10087,372,241,251401,0,935,252949,251401,g,10087
10088,923,186,250019,0,473,251601,250019,g,10088
10089,249297,1132,624,0,487,251540,249297,a,10089
10090,249819,888,320,0,410,251437,249819,a,10090
10091,249067,1239,849,0,250,251405,249067,a,10091
10092,249304,1299,349,0,1122,252074,249304,a,10092
10093,660,275,250339,0,1432,252706,250339,g,10093
10094,244913,1541,236,0,1795,248485,244913,a,10094
10095,500,178,247993,0,634,249305,247993,g,10095
10096,238444,918,161,0,2968,242491,238444,a,10096
10097,241785,1171,488,0,3281,246725,241785,a,10097
10098,930,328,245685,0,660,247603,245685,g,10098
10099,243272,982,811,0,1414,246479,243272,a,10099
10100,1206,240267,3436,0,2516,247425,240267,c,10100
10101,2344,243830,713,0,459,247346,243830,c,10101
10102,244133,652,1595,0,520,246900,244133,a,10102
10103,242616,1236,1192,0,877,245921,242616,a,10103
10104,1113,1079,2711,0,240970,245873,240970,t,10104
10105,3086,895,240551,0,901,245433,240551,g,10105
10106,730,265,243112,0,626,244733,243112,g,10106
10107,3380,1346,1231,0,238647,244604,238647,t,10107
10108,1050,338,242018,0,1051,244457,242018,g,10108
10109,2143,235782,831,0,3479,242235,235782,c,10109
10110,3317,611,235669,0,322,239919,235669,g,10110
10111,616,291,235926,0,2437,239270,235926,g,10111
10112,4746,230988,1040,0,825,237599,230988,c,10112
10113,2211,1210,2981,0,232941,239343,232941,t,10113
10114,2171,236548,1010,0,1545,241274,236548,c,10114
10115,236365,1017,3291,0,489,241162,236365,a,10115
10116,668,488,2856,0,237327,241339,237327,t,10116
10117,1863,2308,1178,0,236992,242341,236992,t,10117
10118,509,198,241666,0,800,243173,241666,g,10118
10119,237212,2042,1613,0,1960,242827,237212,a,10119
10120,1283,347,2676,0,237983,242289,237983,t,10120
10121,1550,1072,590,0,240040,243252,240040,t,10121
10122,2012,796,239815,0,1100,243723,239815,g,10122
10123,1405,627,240893,0,1152,244077,240893,g,10123
10124,635,394,241480,0,2066,244575,241480,g,10124
10125,1763,239545,2365,0,1060,244733,239545,c,10125
10126,2134,226,836,0,241382,244578,241382,t,10126
10127,242754,907,555,0,473,244689,242754,a,10127
10128,241920,1136,1093,0,1721,245870,241920,a,10128
10129,2089,241390,2255,0,966,246700,241390,c,10129
10130,244045,728,608,0,4087,249468,244045,a,10130
10131,247829,1090,885,0,1483,251287,247829,a,10131
10132,1179,468,249102,0,856,251605,249102,g,10132
10133,2815,244546,875,0,1616,249852,244546,c,10133
10134,245809,1056,789,0,723,248377,245809,a,10134
10135,1450,436,243567,0,792,246245,243567,g,10135
10136,3810,843,237395,0,1059,243107,237395,g,10136
10137,1491,337,237339,0,1305,240472,237339,g,10137
10138,2669,234839,653,0,1550,239711,234839,c,10138
10139,3183,231690,2813,0,820,238506,231690,c,10139
10140,231983,1518,1385,0,4540,239426,231983,a,10140
10141,1710,236029,1449,0,1967,241155,236029,c,10141
10142,2288,234779,3160,0,917,241144,234779,c,10142
10143,1215,817,709,0,237306,240047,237306,t,10143
10144,1409,966,236747,0,2202,241324,236747,g,10144
10145,2014,252,236355,0,1776,240397,236355,g,10145
10146,1397,374,236584,0,2627,240982,236584,g,10146
10147,2580,228669,4464,0,1210,236923,228669,c,10147
10148,230567,935,2733,0,503,234738,230567,a,10148
10149,232219,1264,577,0,8455,242515,232219,a,10149
10150,242309,1485,473,0,2605,246872,242309,a,10150
10151,758,224,246192,0,878,248052,246192,g,10151
10152,233614,1354,424,0,382,235774,233614,a,10152
10153,231701,958,4652,0,1404,238715,231701,a,10153
10154,1453,232292,4154,0,1969,239868,232292,c,10154
10155,229667,1065,4221,0,410,235363,229667,a,10155
10156,561,387,902,0,233702,235552,233702,t,10156
10157,1695,231944,628,0,1724,235991,231944,c,10157
10158,1709,224192,8239,0,1647,235787,224192,c,10158
10159,225103,1503,5510,0,1432,233548,225103,a,10159
10160,228127,1120,2246,0,653,232146,228127,a,10160
10161,227826,1317,1020,0,3689,233852,227826,a,10161
10162,2684,220503,7020,0,1368,231575,220503,c,10162
10163,219227,1264,1810,0,427,222728,219227,a,10163
10164,635,220,220775,0,1057,222687,220775,g,10164
10165,1963,215193,2471,0,2533,222160,215193,c,10165
10166,216018,793,2577,0,2849,222237,216018,a,10166
10167,215457,923,4096,0,1289,221765,215457,a,10167
10168,1920,920,3180,0,215778,221798,215778,t,10168
10169,217385,724,2835,0,850,221794,217385,a,10169
10170,215552,1348,4051,0,1806,222757,215552,a,10170
10171,218304,1303,2979,0,379,222965,218304,a,10171
10172,2190,276,1979,0,218426,222871,218426,t,10172
10173,3068,215534,2405,0,636,221643,215534,c,10173
10174,214985,853,2711,0,2060,220609,214985,a,10174
10175,213959,2305,2240,0,8323,226827,213959,a,10175
10176,512,225,226004,0,1399,228140,226004,g,10176
10177,2057,437,4140,0,216617,223251,216617,t,10177
10178,2243,538,1104,0,218883,222768,218883,t,10178
10179,219365,700,1729,0,702,222496,219365,a,10179
10180,734,199,220416,0,962,222311,220416,g,10180
10181,214527,975,686,0,810,216998,214527,a,10181
10182,952,774,2148,0,211397,215271,211397,t,10182
10183,1793,209831,942,0,538,213104,209831,c,10183
10184,1602,204864,1229,0,7684,215379,204864,c,10184
10185,1231,212270,935,0,734,215170,212270,c,10185
10186,640,171,4941,0,207852,213604,207852,t,10186
10187,504,318,1805,0,210663,213290,210663,t,10187
10188,204926,662,4128,0,883,210599,204926,a,10188
10189,912,231,1042,0,209111,211296,209111,t,10189
10190,208765,1281,573,0,567,211186,208765,a,10190
10191,615,265,209717,0,883,211480,209717,g,10191
10192,512,480,208974,0,679,210645,208974,g,10192
10193,1699,204600,3680,0,500,210479,204600,c,10193
10194,208054,931,697,0,478,210160,208054,a,10194
10195,207526,1020,758,0,526,209830,207526,a,10195
10196,4121,480,289,0,204824,209714,204824,t,10196
10197,419,203,206537,0,345,207504,206537,g,10197
10198,205584,978,192,0,4991,211745,205584,a,10198
10199,584,237,212343,0,616,213780,212343,g,10199
10200,822,392,209420,0,1246,211880,209420,g,10200
10201,206939,799,1298,0,2056,211092,206939,a,10201
10202,207738,947,898,0,1085,210668,207738,a,10202
10203,1694,599,2754,0,205532,210579,205532,t,10203
10204,206413,918,607,0,8220,216158,206413,a,10204
10205,1888,214476,1661,0,1896,219921,214476,c,10205
10206,215945,1198,897,0,1963,220003,215945,a,10206
10207,1800,215460,1673,0,2756,221689,215460,c,10207
10208,216104,1257,1728,0,745,219834,216104,a,10208
10209,780,233,217724,0,2552,221289,217724,g,10209
10210,216926,1157,1021,0,1658,220762,216926,a,10210
10211,1184,225,2581,0,216000,219990,216000,t,10211
10212,1421,1310,1730,0,215077,219538,215077,t,10212
10213,215293,531,1722,0,1003,218549,215293,a,10213
10214,1864,212843,2755,0,1002,218464,212843,c,10214
10215,213791,591,1643,0,232,216257,213791,a,10215
10216,1368,1529,1018,0,211029,214944,211029,t,10216
10217,746,749,211008,0,468,212971,211008,g,10217
10218,1660,207086,920,0,3428,213094,207086,c,10218
10219,2030,209605,1117,0,540,213292,209605,c,10219
10220,207873,827,3312,0,316,212328,207873,a,10220
10221,472,196,1110,0,210317,212095,210317,t,10221
10222,1555,206698,2743,0,722,211718,206698,c,10222
10223,1529,205936,742,0,2793,211000,205936,c,10223
10224,208476,1038,773,0,1167,211454,208476,a,10224
10225,393,163,3314,0,208146,212016,208146,t,10225
10226,257,185,211430,0,3134,215006,211430,g,10226
10227,212161,1033,2525,0,1147,216866,212161,a,10227
10228,215570,1126,404,0,431,217531,215570,a,10228
10229,214973,967,1245,0,407,217592,214973,a,10229
10230,215989,959,461,0,322,217731,215989,a,10230
10231,645,158,216633,0,765,218201,216633,g,10231
10232,215445,1844,244,0,341,217874,215445,a,10232
10233,653,237,2212,0,214340,217442,214340,t,10233
10234,453,232,1072,0,216028,217785,216028,t,10234
10235,1440,213875,881,0,1682,217878,213875,c,10235
10236,213547,925,1238,0,1550,217260,213547,a,10236
10237,712,104,215434,0,485,216735,215434,g,10237
10238,212964,1026,427,0,1298,215715,212964,a,10238
10239,212449,1163,363,0,1767,215742,212449,a,10239
10240,483,1008,212468,0,843,214802,212468,g,10240
10241,210632,1205,1346,0,1225,214408,210632,a,10241
10242,521,275,213310,0,860,214966,213310,g,10242
10243,210130,1284,229,0,1177,212820,210130,a,10243
10244,210539,889,699,0,1073,213200,210539,a,10244
10245,1604,434,209570,0,1269,212877,209570,g,10245
10246,204755,1763,965,0,7928,215411,204755,a,10246
10247,356,223,217741,0,1075,219395,217741,g,10247
10248,1760,265,214072,0,643,216740,214072,g,10248
10249,213595,914,1077,0,1278,216864,213595,a,10249
10250,215114,1069,373,0,529,217085,215114,a,10250
10251,1090,372,213803,0,1238,216503,213803,g,10251
10252,213303,1499,443,0,3185,218430,213303,a,10252
10253,555,304,218351,0,1320,220530,218351,g,10253
10254,945,626,217460,0,3514,222545,217460,g,10254
10255,3370,217303,1330,0,1893,223896,217303,c,10255
10256,220283,899,381,0,1470,223033,220283,a,10256
10257,1881,471,220330,0,340,223022,220330,g,10257
10258,856,296,220562,0,552,222266,220562,g,10258
10259,215171,3058,841,0,1834,220904,215171,a,10259
10260,2462,507,217388,0,911,221268,217388,g,10260
10261,2125,974,993,0,216950,221042,216950,t,10261
10262,2361,215692,908,0,2735,221696,215692,c,10262
10263,1402,216949,2592,0,931,221874,216949,c,10263
10264,1032,821,1617,0,218453,221923,218453,t,10264
10265,586,402,219710,0,1006,221704,219710,g,10265
10266,2108,792,1344,0,215809,220053,215809,t,10266
10267,1538,672,216555,0,2705,221470,216555,g,10267
10268,1657,426,215200,0,721,218004,215200,g,10268
10269,3809,985,3119,0,207545,215458,207545,t,10269
10270,211224,1893,936,0,607,214660,211224,a,10270
10271,2318,321,210161,0,761,213561,210161,g,10271
10272,206708,1667,885,0,570,209830,206708,a,10272
10273,204023,1861,1611,0,8308,215803,204023,a,10273
10274,1898,1677,213370,0,2771,219716,213370,g,10274
10275,936,265,215437,0,1696,218334,215437,g,10275
10276,3143,209806,3171,0,1346,217466,209806,c,10276
10277,212973,1383,1018,0,519,215893,212973,a,10277
10278,211414,1045,2360,0,576,215395,211414,a,10278
10279,210474,884,2820,0,535,214713,210474,a,10279
10280,210875,928,899,0,3213,215915,210875,a,10280
10281,3550,210424,2311,0,421,216706,210424,c,10281
10282,1035,1795,2029,0,210544,215403,210544,t,10282
10283,210186,1066,2670,0,1305,215227,210186,a,10283
10284,210491,529,2209,0,3174,216403,210491,a,10284
10285,3570,210853,1118,0,1826,217367,210853,c,10285
10286,209774,1101,2358,0,774,214007,209774,a,10286
10287,1123,429,2914,0,209225,213691,209225,t,10287
10288,904,581,211569,0,1414,214468,211569,g,10288
10289,209848,571,2442,0,1814,214675,209848,a,10289
10290,212682,728,856,0,377,214643,212682,a,10290
10291,210747,815,1527,0,2087,215176,210747,a,10291
10292,6154,206287,1883,0,685,215009,206287,c,10292
10293,194888,1008,2901,0,337,199134,194888,a,10293
10294,193869,1086,2180,0,1697,198832,193869,a,10294
10295,3048,1706,193389,0,2322,200465,193389,g,10295
10296,1979,454,184463,0,8215,195111,184463,g,10296
10297,4297,185292,5774,0,1467,196830,185292,c,10297
10298,4131,1004,1761,0,188587,195483,188587,t,10298
10299,191501,1884,1523,0,816,195724,191501,a,10299
10300,1969,377,192480,0,636,195462,192480,g,10300
10301,190960,1139,1921,0,583,194603,190960,a,10301
10302,187430,3073,1477,0,8463,200443,187430,a,10302
10303,2262,2216,198830,0,527,203835,198830,g,10303
10304,2076,920,2157,0,198009,203162,198009,t,10304
10305,2926,198291,1258,0,857,203332,198291,c,10305
10306,195155,1385,5357,0,1534,203431,195155,a,10306
10307,981,1294,197699,0,9698,209672,197699,g,10307
10308,5006,423,195253,0,578,201260,195253,g,10308
10309,2065,1124,2066,0,193472,198727,193472,t,10309
10310,4468,191637,1622,0,867,198594,191637,c,10310
10311,800,350,196111,0,1004,198265,196111,g,10311
10312,469,603,194627,0,1724,197423,194627,g,10312
10313,190794,1647,3136,0,811,196388,190794,a,10313
10314,7039,466,1517,0,186464,195486,186464,t,10314
10315,3464,424,5739,0,185129,194756,185129,t,10315
10316,191297,725,1700,0,1573,195295,191297,a,10316
10317,188258,2100,4621,0,2085,197064,188258,a,10317
10318,2671,2656,191887,0,1183,198397,191887,g,10318
10319,3771,184483,4641,0,2903,195798,184483,c,10319
10320,2516,183168,2637,0,3632,191953,183168,c,10320
10321,182915,3191,4030,0,726,190862,182915,a,10321
10322,1602,413,4175,0,183908,190098,183908,t,10322
10323,182082,1777,660,0,4165,188684,182082,a,10323
10324,1483,378,186991,0,1039,189891,186991,g,10324
10325,3846,1162,1400,0,181000,187408,181000,t,10325
10326,182146,884,1511,0,2896,187437,182146,a,10326
10327,2473,177180,6483,0,3327,189463,177180,c,10327
10328,1075,472,187722,0,8138,197407,187722,g,10328
10329,3313,266,196059,0,2512,202150,196059,g,10329
10330,198341,1358,1423,0,1470,202592,198341,a,10330
10331,199712,940,1155,0,625,202432,199712,a,10331
10332,199307,959,1465,0,909,202640,199307,a,10332
10333,195810,829,5022,0,1144,202805,195810,a,10333
10334,198862,1386,2137,0,370,202755,198862,a,10334
10335,194941,1303,4799,0,2077,203120,194941,a,10335
10336,2585,194245,3032,0,3551,203413,194245,c,10336
10337,952,490,4317,0,197722,203481,197722,t,10337
10338,197231,1325,1531,0,3535,203622,197231,a,10338
10339,4445,396,2121,0,197170,204132,197170,t,10339
10340,1222,337,201748,0,1369,204676,201748,g,10340
10341,4707,196924,1803,0,678,204112,196924,c,10341
10342,2006,1054,698,0,199947,203705,199947,t,10342
10343,197798,3557,621,0,1758,203734,197798,a,10343
10344,2609,197034,837,0,4254,204734,197034,c,10344
10345,1283,202081,1087,0,969,205420,202081,c,10345
10346,842,495,3097,0,203126,207560,203126,t,10346
10347,515,230,207146,0,979,208870,207146,g,10347
10348,1242,491,1132,0,205485,208350,205485,t,10348
10349,863,391,205749,0,1024,208027,205749,g,10349
10350,203246,1044,2071,0,2229,208590,203246,a,10350
10351,951,342,206228,0,2441,209962,206228,g,10351
10352,1527,207142,376,0,2122,211167,207142,c,10352
10353,1341,208558,1463,0,710,212072,208558,c,10353
10354,1283,209677,413,0,1220,212593,209677,c,10354
10355,1221,210665,355,0,2825,215066,210665,c,10355
10356,475,477,214693,0,546,216191,214693,g,10356
10357,997,581,649,0,213967,216194,213967,t,10357
10358,1929,213305,322,0,3495,219051,213305,c,10358
10359,1211,218394,284,0,1167,221056,218394,c,10359
10360,218780,1646,238,0,709,221373,218780,a,10360
10361,219490,1478,196,0,2436,223600,219490,a,10361
10362,970,412,222299,0,717,224398,222299,g,10362
10363,613,258,222964,0,414,224249,222964,g,10363
10364,221775,1579,388,0,1294,225036,221775,a,10364
10365,1921,222951,199,0,3431,228502,222951,c,10365
10366,286,295,228903,0,513,229997,228903,g,10366
10367,713,350,439,0,228725,230227,228725,t,10367
10368,335,212,323,0,230315,231185,230315,t,10368
10369,229925,1054,160,0,1837,232976,229925,a,10369
10370,232224,1106,176,0,677,234183,232224,a,10370
10371,232730,1076,209,0,812,234827,232730,a,10371
10372,233481,1128,300,0,273,235182,233481,a,10372
10373,1688,248,232668,0,307,234911,232668,g,10373
10374,231405,967,177,0,932,233481,231405,a,10374
10375,232338,791,699,0,1684,235512,232338,a,10375
10376,2092,320,231872,0,475,234759,231872,g,10376
10377,2026,959,645,0,227989,231619,227989,t,10377
10378,2167,228116,452,0,567,231302,228116,c,10378
10379,227463,952,1194,0,1970,231579,227463,a,10379
10380,2061,437,226361,0,1504,230363,226361,g,10380
10381,2553,736,214728,0,930,218947,214728,g,10381
10382,4980,207741,1348,0,1349,215418,207741,c,10382
10383,2155,206778,4072,0,1836,214841,206778,c,10383
10384,210850,1698,1937,0,852,215337,210850,a,10384
10385,1047,486,1537,0,212356,215426,212356,t,10385
10386,847,3934,1196,0,209788,215765,209788,t,10386
10387,209367,1187,4203,0,3449,218206,209367,a,10387
10388,1999,211857,5322,0,2495,221673,211857,c,10388
10389,218569,1228,1589,0,738,222124,218569,a,10389
10390,219674,1134,986,0,734,222528,219674,a,10390
10391,216716,1278,4009,0,506,222509,216716,a,10391
10392,4996,1040,1818,0,215111,222965,215111,t,10392
10393,1551,577,218913,0,843,221884,218913,g,10393
10394,1594,215772,1977,0,3172,222515,215772,c,10394
10395,1806,219322,2456,0,1023,224607,219322,c,10395
10396,214036,1642,3230,0,1659,220567,214036,a,10396
10397,1529,1859,2169,0,215088,220645,215088,t,10397
10398,214741,3294,2136,0,1881,222052,214741,a,10398
10399,1796,739,216751,0,6959,226245,216751,g,10399
10400,1735,221603,2279,0,1836,227453,221603,c,10400
10401,943,382,3473,0,222444,227242,222444,t,10401
10402,2082,914,1180,0,224963,229139,224963,t,10402
10403,2534,487,226002,0,2186,231209,226002,g,10403
10404,225776,1012,3267,0,3500,233555,225776,a,10404
10405,731,219,231672,0,322,232944,231672,g,10405
10406,2533,913,2376,0,226661,232483,226661,t,10406
10407,230426,760,939,0,603,232728,230426,a,10407
10408,230356,1161,465,0,541,232523,230356,a,10408
10409,230162,993,610,0,1090,232855,230162,a,10409
10410,1662,227581,2664,0,844,232751,227581,c,10410
10411,2973,747,646,0,227859,232225,227859,t,10411
10412,569,335,230918,0,1148,232970,230918,g,10412
10413,1798,448,938,0,230478,233662,230478,t,10413
10414,1302,295,231322,0,815,233734,231322,g,10414
10415,2030,227497,860,0,1859,232246,227497,c,10415
10416,226173,953,1073,0,1261,229460,226173,a,10416
10417,1305,330,226816,0,2807,231258,226816,g,10417
10418,2430,226547,358,0,2551,231886,226547,c,10418
10419,1337,228170,1309,0,4881,235697,228170,c,10419
10420,819,1108,2310,0,232911,237148,232911,t,10420
10421,498,397,235789,0,457,237141,235789,g,10421
10422,2196,473,1291,0,233130,237090,233130,t,10422
10423,234150,1298,1045,0,1173,237666,234150,a,10423
10424,1056,389,236009,0,2938,240392,236009,g,10424
10425,2681,236329,1258,0,399,240667,236329,c,10425
10426,784,1463,2014,0,235798,240059,235798,t,10426
10427,1640,236742,328,0,744,239454,236742,c,10427
10428,1430,235450,1949,0,548,239377,235450,c,10428
10429,235152,1677,705,0,1899,239433,235152,a,10429
10430,1392,236758,753,0,1101,240004,236758,c,10430
10431,1129,236864,1822,0,920,240735,236864,c,10431
10432,588,250,476,0,239799,241113,239799,t,10432
10433,426,253,240238,0,1291,242208,240238,g,10433
10434,238531,2285,1050,0,1078,242944,238531,a,10434
10435,1007,336,241291,0,419,243053,241291,g,10435
10436,239806,2113,291,0,337,242547,239806,a,10436
10437,239783,2003,409,0,316,242511,239783,a,10437
10438,1351,250,240666,0,347,242614,240666,g,10438
10439,468,226,241580,0,292,242566,241580,g,10439
10440,3310,1549,1540,0,236474,242873,236474,t,10440
10441,290,183,242213,0,294,242980,242213,g,10441
10442,1275,457,659,0,244035,246426,244035,t,10442
10443,245669,854,352,0,676,247551,245669,a,10443
10444,246068,1085,836,0,626,248615,246068,a,10444
10445,246643,1281,215,0,588,248727,246643,a,10445
10446,246645,1230,270,0,440,248585,246645,a,10446
10447,244163,1238,535,0,533,246469,244163,a,10447
10448,244679,1088,142,0,224,246133,244679,a,10448
10449,553,180,275,0,245944,246952,245944,t,10449
10450,1702,240613,112,0,1055,243482,240613,c,10450
10451,618,475,585,0,239997,241675,239997,t,10451
10452,666,971,236362,0,774,238773,236362,g,10452
10453,2049,209,228639,0,431,231328,228639,g,10453
10454,1861,293,226042,0,857,229053,226042,g,10454
10455,222230,1290,354,0,706,224580,222230,a,10455
10456,1485,435,220957,0,1566,224443,220957,g,10456
10457,2535,1260,218117,0,2644,224556,218117,g,10457
10458,1254,219460,2433,0,7909,231056,219460,c,10458
10459,2062,226733,2688,0,402,231885,226733,c,10459
10460,225014,1138,2989,0,2033,231174,225014,a,10460
10461,2470,225421,2234,0,2458,232583,225421,c,10461
10462,227612,1467,2063,0,444,231586,227612,a,10462
10463,227153,1235,2317,0,707,231412,227153,a,10463
10464,226214,2076,1957,0,1030,231277,226214,a,10464
10465,1609,224908,3131,0,1964,231612,224908,c,10465
10466,2160,223001,1883,0,1432,228476,223001,c,10466
10467,222446,1469,2641,0,553,227109,222446,a,10467
10468,583,633,2779,0,225239,229234,225239,t,10468
10469,701,990,227573,0,519,229783,227573,g,10469
10470,1570,341,224041,0,1906,227858,224041,g,10470
10471,223735,1509,1145,0,910,227299,223735,a,10471
10472,224151,1721,717,0,759,227348,224151,a,10472
10473,3030,589,221971,0,1605,227195,221971,g,10473
10474,2339,218277,3270,0,362,224248,218277,c,10474
10475,1612,332,1792,0,220271,224007,220271,t,10475
10476,551,723,221702,0,215,223191,221702,g,10476
10477,2101,443,952,0,217466,220962,217466,t,10477
10478,215960,1399,1466,0,1936,220761,215960,a,10478
10479,2124,214085,3347,0,1355,220911,214085,c,10479
10480,1806,273,217412,0,490,219981,217412,g,10480
10481,2246,212642,3569,0,804,219261,212642,c,10481
10482,215537,1554,1603,0,393,219087,215537,a,10482
10483,3106,617,1360,0,214114,219197,214114,t,10483
10484,3065,2135,213473,0,367,219040,213473,g,10484
10485,521,288,216408,0,1078,218295,216408,g,10485
10486,2562,213175,699,0,1712,218148,213175,c,10486
10487,562,161,216761,0,291,217775,216761,g,10487
10488,1739,476,1161,0,214012,217388,214012,t,10488
10489,212745,2328,972,0,1144,217189,212745,a,10489
10490,810,241,215939,0,827,217817,215939,g,10490
10491,1839,777,1853,0,212854,217323,212854,t,10491
10492,1075,357,215046,0,318,216796,215046,g,10492
10493,1763,256,212762,0,1007,215788,212762,g,10493
10494,212590,1266,639,0,1144,215639,212590,a,10494
10495,3295,210510,865,0,495,215165,210510,c,10495
10496,1808,549,1761,0,210205,214323,210205,t,10496
10497,210739,1545,333,0,210,212827,210739,a,10497
10498,717,271,210933,0,599,212520,210933,g,10498
10499,2110,208141,568,0,771,211590,208141,c,10499
10500,343,129,210220,0,977,211669,210220,g,10500
10501,1452,313,200111,0,1046,202922,200111,g,10501
10502,3316,1299,3626,0,192318,200559,192318,t,10502
10503,1512,1024,1301,0,194103,197940,194103,t,10503
10504,194164,1918,957,0,482,197521,194164,a,10504
10505,2127,638,193486,0,1224,197475,193486,g,10505
10506,189141,2494,1185,0,1539,194359,189141,a,10506
10507,2030,359,190849,0,739,193977,190849,g,10507
10508,1204,498,186890,0,900,189492,186890,g,10508
10509,183054,1763,1161,0,860,186838,183054,a,10509
10510,4207,527,181449,0,340,186523,181449,g,10510
10511,173773,1779,2338,0,939,178829,173773,a,10511
10512,5269,168067,3089,0,2036,178461,168067,c,10512
10513,3417,168832,2906,0,1279,176434,168832,c,10513
10514,1384,172288,1388,0,2228,177288,172288,c,10514
10515,1675,170989,4543,0,237,177444,170989,c,10515
10516,1212,2469,1497,0,171391,176569,171391,t,10516
10517,1559,172585,1649,0,576,176369,172585,c,10517
10518,1640,168867,4462,0,1261,176230,168867,c,10518
10519,1887,169213,1737,0,3057,175894,169213,c,10519
10520,1156,812,4643,0,168914,175525,168914,t,10520
10521,1339,371,1141,0,172695,175546,172695,t,10521
10522,171815,1695,1501,0,579,175590,171815,a,10522
10523,3012,169064,2850,0,638,175564,169064,c,10523
10524,171056,2198,1692,0,326,175272,171056,a,10524
10525,171576,1386,1639,0,809,175410,171576,a,10525
10526,172799,1655,718,0,104,175276,172799,a,10526
10527,3570,662,2727,0,168489,175448,168489,t,10527
10528,3542,169321,624,0,1143,174630,169321,c,10528
10529,1076,1149,169342,0,1059,172626,169342,g,10529
10530,1680,167143,960,0,1850,171633,167143,c,10530
10531,163503,2661,1631,0,420,168215,163503,a,10531
10532,1372,426,165050,0,1419,168267,165050,g,10532
10533,3253,161144,1266,0,508,166171,161144,c,10533
10534,161103,2135,1420,0,642,165300,161103,a,10534
10535,162535,1226,620,0,807,165188,162535,a,10535
10536,3619,159068,1400,0,813,164900,159068,c,10536
10537,159399,2842,1077,0,544,163862,159399,a,10537
10538,159483,1660,1167,0,1287,163597,159483,a,10538
10539,2682,3321,1506,0,156694,164203,156694,t,10539
10540,2313,826,159085,0,837,163061,159085,g,10540
10541,2930,409,155961,0,771,160071,155961,g,10541
10542,2706,682,152307,0,977,156672,152307,g,10542
10543,5019,1045,139985,0,565,146614,139985,g,10543
10544,2798,454,127202,0,3163,133617,127202,g,10544
10545,5130,121235,2428,0,2021,130814,121235,c,10545
10546,3146,118708,6219,0,2252,130325,118708,c,10546
10547,2023,119393,5933,0,1347,128696,119393,c,10547
10548,122761,2433,2402,0,689,128285,122761,a,10548
10549,122988,1671,2066,0,1700,128425,122988,a,10549
10550,2332,1688,123559,0,1969,129548,123559,g,10550
10551,1423,333,125862,0,390,128008,125862,g,10551
10552,5661,3675,7844,0,109758,126938,109758,t,10552
10553,1532,1005,123332,0,706,126575,123332,g,10553
10554,118608,2498,2110,0,2943,126159,118608,a,10554
10555,2213,2115,120776,0,570,125674,120776,g,10555
10556,111790,2314,6168,0,1517,121789,111790,a,10556
10557,1986,981,5919,0,112292,121178,112292,t,10557
10558,3450,885,115898,0,509,120742,115898,g,10558
10559,114724,1541,1386,0,2302,119953,114724,a,10559
10560,116989,1599,728,0,502,119818,116989,a,10560
10561,2930,1058,113933,0,1589,119510,113933,g,10561
10562,3220,107809,5016,0,522,116567,107809,c,10562
10563,1494,1040,3122,0,109785,115441,109785,t,10563
10564,1239,550,113023,0,399,115211,113023,g,10564
10565,2862,778,1951,0,108925,114516,108925,t,10565
10566,111105,1692,643,0,436,113876,111105,a,10566
10567,2086,322,110704,0,360,113472,110704,g,10567
10568,2947,951,1777,0,107472,113147,107472,t,10568
10569,2038,107640,2598,0,446,112722,107640,c,10569
10570,1453,2573,666,0,107480,112172,107480,t,10570
10571,1806,107801,1442,0,280,111329,107801,c,10571
10572,104013,2944,3001,0,1150,111108,104013,a,10572
10573,2120,105120,3629,0,202,111071,105120,c,10573
10574,893,698,2591,0,106489,110671,106489,t,10574
10575,569,267,108458,0,1033,110327,108458,g,10575
10576,746,190,108189,0,440,109565,108189,g,10576
10577,103733,1991,1078,0,2034,108836,103733,a,10577
10578,105429,2128,573,0,194,108324,105429,a,10578
10579,2229,476,105056,0,198,107959,105056,g,10579
10580,825,917,105003,0,166,106911,105003,g,10580
10581,102140,1965,1651,0,698,106454,102140,a,10581
10582,3158,101252,1453,0,258,106121,101252,c,10582
10583,1931,598,578,0,101929,105036,101929,t,10583
10584,101567,1381,611,0,253,103812,101567,a,10584
10585,1714,397,100996,0,409,103516,100996,g,10585
10586,97391,1798,1019,0,310,100518,97391,a,10586
10587,801,267,98458,0,966,100492,98458,g,10587
10588,1774,770,93800,0,661,97005,93800,g,10588
10589,2080,815,3962,0,89409,96266,89409,t,10589
10590,1134,1700,507,0,92613,95954,92613,t,10590
10591,92300,1222,1529,0,518,95569,92300,a,10591
10592,1678,678,92714,0,291,95361,92714,g,10592
10593,84796,1055,1224,0,516,87591,84796,a,10593
10594,1996,287,84143,0,354,86780,84143,g,10594
10595,3694,563,74945,0,445,79647,74945,g,10595
10596,75675,882,1111,0,830,78498,75675,a,10596
10597,2813,643,74616,0,226,78298,74616,g,10597
10598,70549,1391,1385,0,299,73624,70549,a,10598
10599,3058,63010,5422,0,930,72420,63010,c,10599
10600,2536,65305,987,0,776,69604,65305,c,10600
10601,1200,62870,4088,0,1114,69272,62870,c,10601
10602,1371,63147,1836,0,2723,69077,63147,c,10602
10603,1302,63526,1571,0,1402,67801,63526,c,10603
10604,853,61050,4866,0,305,67074,61050,c,10604
10605,1720,59446,1506,0,2832,65504,59446,c,10605
10606,59373,1596,3406,0,372,64747,59373,a,10606
10607,58903,705,2141,0,2620,64369,58903,a,10607
10608,61933,777,833,0,639,64182,61933,a,10608
10609,58910,710,3819,0,617,64056,58910,a,10609
10610,1810,58251,3534,0,199,63794,58251,c,10610
10611,57707,907,3968,0,160,62742,57707,a,10611
10612,59722,615,1550,0,482,62369,59722,a,10612
10613,59946,948,934,0,289,62117,59946,a,10613
10614,59282,577,1396,0,403,61658,59282,a,10614
10615,56779,887,2451,0,507,60624,56779,a,10615
10616,57315,597,1293,0,344,59549,57315,a,10616
10617,2159,53074,3416,0,399,59048,53074,c,10617
10618,46571,855,1520,0,1275,50221,46571,a,10618
10619,1386,348,47553,0,471,49758,47553,g,10619
10620,3643,40761,1279,0,1480,47163,40761,c,10620
10621,43385,667,1539,0,273,45864,43385,a,10621
10622,1825,717,4748,0,38369,45659,38369,t,10622
10623,43515,1075,699,0,138,45427,43515,a,10623
10624,1768,415,3718,0,38948,44849,38948,t,10624
10625,1208,3226,1150,0,38942,44526,38942,t,10625
10626,1291,1197,40562,0,1150,44200,40562,g,10626
10627,38849,887,1864,0,2339,43939,38849,a,10627
10628,1514,40604,888,0,708,43714,40604,c,10628
10629,523,341,42302,0,171,43337,42302,g,10629
10630,1413,35741,1757,0,2858,41769,35741,c,10630
10631,3344,1433,1572,0,34983,41332,34983,t,10631
10632,643,564,38565,0,327,40099,38565,g,10632
10633,392,203,38518,0,406,39519,38518,g,10633
10634,461,217,37328,0,276,38282,37328,g,10634
10635,35252,699,960,0,432,37343,35252,a,10635
10636,35961,547,512,0,104,37124,35961,a,10636
10637,35581,547,724,0,109,36961,35581,a,10637
10638,1247,325,35057,0,155,36784,35057,g,10638
10639,34783,580,867,0,158,36388,34783,a,10639
10640,1463,30686,3900,0,156,36205,30686,c,10640
10641,1440,30640,1320,0,2110,35510,30640,c,10641
10642,30994,597,3517,0,139,35247,30994,a,10642
10643,1546,370,30508,0,2317,34741,30508,g,10643
10644,33030,581,395,0,101,34107,33030,a,10644
10645,1491,252,32078,0,161,33982,32078,g,10645
10646,32520,505,342,0,152,33519,32520,a,10646
10647,1847,341,588,0,30585,33361,30585,t,10647
10648,1299,31296,207,0,272,33074,31296,c,10648
10649,1027,29515,695,0,1464,32701,29515,c,10649
10650,1080,1883,1309,0,27954,32226,27954,t,10650
10651,500,332,30735,0,140,31707,30735,g,10651
10652,970,27036,1657,0,585,30248,27036,c,10652
10653,982,362,1456,0,26359,29159,26359,t,10653
10654,638,108,27769,0,131,28646,27769,g,10654
10655,701,196,975,0,26206,28078,26206,t,10655
10656,940,26362,474,0,131,27907,26362,c,10656
10657,606,584,1667,0,24818,27675,24818,t,10657
10658,583,25827,712,0,79,27201,25827,c,10658
10659,675,25324,345,0,39,26383,25324,c,10659
10660,702,368,977,0,24034,26081,24034,t,10660
10661,597,24171,585,0,297,25650,24171,c,10661
10662,24918,254,166,0,39,25377,24918,a,10662
10663,462,129,24238,0,267,25096,24238,g,10663
10664,489,24005,160,0,76,24730,24005,c,10664
10665,23743,302,394,0,27,24466,23743,a,10665
10666,288,92,143,0,23749,24272,23749,t,10666
10667,424,23380,128,0,175,24107,23380,c,10667
10668,23173,343,271,0,34,23821,23173,a,10668
10669,231,69,270,0,22887,23457,22887,t,10669
10670,181,54,189,0,22827,23251,22827,t,10670
10671,289,22313,273,0,134,23009,22313,c,10671
10672,370,21742,144,0,224,22480,21742,c,10672
10673,21665,222,187,0,35,22109,21665,a,10673
10674,347,52,20927,0,70,21396,20927,g,10674
10675,1152,154,12615,0,72,13993,12615,g,10675
10676,1077,6956,1582,0,97,9712,6956,c,10676
10677,7965,92,454,0,692,9203,7965,a,10677
10678,1251,7177,246,0,427,9101,7177,c,10678
10679,8254,231,696,0,26,9207,8254,a,10679
10680,121,34,8817,0,26,8998,8817,g,10680
10681,8477,94,228,0,20,8819,8477,a,10681
10682,6510,63,1694,0,498,8765,6510,a,10682
10683,401,7727,395,0,125,8648,7727,c,10683
10684,386,64,7271,0,47,7768,7271,g,10684
10685,342,4660,916,0,1637,7555,4660,c,10685
10686,678,5817,340,0,202,7037,5817,c,10686
10687,3769,269,1281,0,161,5480,3769,a,10687
10688,204,103,4521,0,519,5347,4521,g,10688
10689,2727,123,939,0,795,4584,2727,a,10689
10690,1950,100,1815,0,633,4498,1950,a,10690
10691,2747,464,313,0,927,4451,2747,a,10691
10692,2745,75,1191,0,296,4307,2745,a,10692
10693,209,352,1896,0,1710,4167,1896,g,10693
10694,514,353,3192,0,34,4093,3192,g,10694
10695,416,90,3256,0,233,3995,3256,g,10695
10696,3048,189,153,0,420,3810,3048,a,10696
10697,2825,56,718,0,79,3678,2825,a,10697
10698,878,164,726,0,1765,3533,1765,t,10698
10699,995,320,2113,0,33,3461,2113,g,10699
10700,216,31,2863,0,244,3354,2863,g,10700
10701,524,266,309,0,2137,3236,2137,t,10701
10702,93,103,2699,0,220,3115,2699,g,10702
10703,441,662,399,0,787,2289,787,t,10703
10704,737,176,299,0,908,2120,908,t,10704
10705,172,391,1405,0,7,1975,1405,g,10705
10706,517,38,350,0,884,1789,884,t,10706
10707,276,340,395,0,633,1644,633,t,10707
10708,131,326,941,0,82,1480,941,g,10708
10709,485,44,326,0,298,1153,485,a,10709
10710,390,184,255,0,70,899,390,a,10710
10711,118,58,266,0,233,675,266,g,10711
10712,102,258,207,0,36,603,258,c,10712
10713,261,58,118,0,100,537,261,a,10713
10714,261,69,127,0,25,482,261,a,10714
10715,43,149,153,0,63,408,153,g,10715
10716,184,45,96,0,31,356,184,a,10716
10717,28,21,227,0,40,316,227,g,10717
10718,33,18,200,0,14,265,200,g,10718
10719,26,15,51,0,88,180,88,t,10719
10720,24,25,48,0,40,137,48,g,10720
10721,19,24,36,0,1,80,36,g,10721
10722,9,5,16,0,19,49,19,t,10722
